word	meaning
abandon	vt.放棄，中止
abdomen	n.腹；腹部
absolute	a.絕對的；完全的
absorb	vt.吸收；吸引(注意等)；使專注
abstract	a.抽象的 n.摘要，梗概
academic	a.學術的
accent	n.口音，腔調；重音；強調
acceptance	n.接受；歡迎
access	n.接近，進入；通道，入口
access	vt.使用；接近
accidental	a.偶然的；意外的
accompany	vt.陪伴；為...伴奏
accomplish	vt.完成，實現，達到
accomplishment	n.成就；成績[C]
accountant	n.會計師；會計人員
accuracy	n.正確(性)；準確(性)
accuse	vt.指控，控告；譴責
acid	a.酸的，有酸味的 n.【化】酸[C][U]
acquaint	vt.使認識；使熟悉
acquaintance	n.(與人)相識[U]；
acquaintance	n.相識的人，熟人[C]
acquire	vt.取得，獲得；學到
acre	n.英畝
adapt	vt.使適應，使適合；改編，改寫
adequate	a.適當的；足夠的
adjective	n.形容詞 a.形容詞的
adjust	vt.調節；校準；調整
adjustment	n.調節；調整；校正
admirable	a.值得讚揚的；令人欽佩的
admiration	n.欽佩，讚美，羨慕
admission	n.(學校，會場，俱樂部等的)進入許可；入場費[U]；入場券[C]；承認[C]
adverb	n.副詞 a.副詞的
agency	n.代辦處，經銷處
agent	n.代理人；代理商；仲介人
aggressive	a.侵略的，有進取精神的
agreeable	a.令人愉快的，宜人的
AIDS	n.愛滋病
Alcohol	n.酒精；含酒精飲料；酒[U]
alert	a.警覺的；警惕的 n.警戒，警報
alert	vt.使警覺；使注意
allowance	n.零用錢；津貼，補貼 同：pocket money
aluminum	n.鋁[U]
amateur	n.業餘從事者
ambitious	a.有雄心的；野心勃勃的
amid	prep.在...之間；在...之中(amidst)
amuse	vt.使歡樂，逗...高興
amusement	n.樂趣；娛樂，消遣
analysis	n.分析；分解；解析[C][U]
analyze	vt.分析；解析
ancestor	n.祖宗，祖先
anniversary	n.週年紀念日
annoy	vt.惹惱，使生氣
annual	a.一年的；一年一次的
anxiety	n.焦慮，掛念
anxious	a.焦慮的，掛念的
apologize	vi.道歉；認錯
apology	n.道歉；陪罪[(+to/for)]
appliance	n.器具，用具；裝置，設備[C]
applicant	n.申請人[C][(+for)]
application	n.應用，適用；
appoint	vt.任命，指派
appointment	n.約會
appreciation	n.欣賞；賞識；感謝
appropriate	a.適當的，恰當的
approval	n.批准；認可；贊成；同意
arch	n.拱，拱門，牌樓
arise	vi.上升；產生，出現；【舊】起立
arms	n.武器
arouse	vt.喚起；使奮發
articl?	n.冠詞；文章；物品；條文
artificial	a.人工的，人造的；假的
artistic	a.藝術的；美術的
ashamed	a.羞愧的，感到難為情的aspect
aspirin	n.阿斯匹靈(解熱鎮痛藥)
assemble	vt.集合，召集；組合，配裝
assembly	n.集會；集合
assign	vt.分配，分派；指定
assignment	n.(分派的)任務；工作[C];
assistance	n.援助，幫助[U][(+in)]
associate	n.夥伴；同事；合夥人
associate	vt.聯想
association	n.協(公)會；聯想，聯想物
assume	vt.以為；假定為；承擔；就任
assurance	n.保證
assure	vt.向...保證，擔保；
athletic	a. 運動的，體育的
atmosphere	n.大氣層；氣氛
atom	n.原子
atomic	a.原子的
attach	vt.裝上，貼上，繫上[(+to)]
attachment	n.連接；附著[U][(+to)]；
Attraction	n.吸引；吸引力[U]；吸引物[C]
audio	a. 聽覺的，聲音的
authority	n.權力；職權[U]；官方，當局；權威人士;專家
autobiography	] n.自傳
await	vt.等候，期待
awkward	a.笨拙的 [(+with)]；尷尬的
backpack	n.登山、遠足用的背包
bald	a.禿頭的；無草木的
ballet	n.芭蕾舞[C][U]
bankrupt	a.破產的 vt.使破產 n.破產者
bargain	vt.討價還價; n買賣，交易，特價商品
barrier	n.障礙物；路障，柵欄
basin	n.盆；臉盆；盆地
battery	n.電池
beak	n.鳥嘴
beam2	n.笑容，喜色
behavior	n.行為，舉止 [U]
biography	n.傳記[C]
biology	] n.生物學[U]
blade	n.刀身，劍身；刀片
blend	vt.vi.使混和，使混雜；使交融blessing
blink	vi.vt.n.眨眼睛；瞇著眼看[(+at)]
bloom	n.(尤指觀賞的)花；開花(期)[U] vi.開花
blossom	n.(尤指果樹的)花[C];開花(期)[U]
blush	vi.n.(因害羞，尷尬等而)臉紅
boast	vi.n.自吹自擂；誇耀；吹牛
bond	n.結合力；聯結；契約，約定[C]
bounce	vt.vi.n.(球)彈起，彈回；蹦跳
bracelet	n.手鐲；臂鐲
brassiere	n.胸罩 = bra [br?]
breed	vt.vi.(動物)產(子)，孵(卵)；繁殖；養育
bridegroom	n.新郎 (= groom)
broil	vt.vi.n.烤，炙
broke	a.【口】破了產的；一文不名的
brutal	a.殘忍的，冷酷的；野蠻的
bulletin	n.公告；公報
cabinet	n.櫥，櫃[C]；內閣；全體閣員
calculate	vt.vi.計算
calculation	n.計算[U]
calculator	n.計算者(機)
calorie	n.卡，卡路里
campaign	n.戰役；運動，活動
Candidate	n.候選人；候補者；應徵者
Capacity	n.容量，容積；能力，才能
cape	n.披肩；斗篷；岬，海角
capital	n.首都；大寫字母；資本
capitalism	n.資本主義(制度)[U]
capitalist	n.資本家；資本主義者
career	n.(終身的)職業[C]；生涯；歷程[C]
cargo	n.(船、飛機、車輛裝載的)貨物
carrier	n.運送人；送信人；航空母艦
carve	vi.刻，雕刻
catalogue/catalog	n.(圖書，商品的)目錄
cease	n.vt.vi.停止，終止
celebration	n.慶祝[U]；慶祝活動[C]
cement	n.水泥[U]
chamber	n.房間；寢室
championship	n.友誼
characteristic	n.特性，特徵
charity	n.慈悲；慈善[U]；慈善團體[C]
chemistry	n.化學；男女間的來電
cherish	vt.珍愛；珍惜
chirp	vi.n.(小鳥)發啁啾聲；(昆蟲)發唧唧聲
chore	n.家庭雜務；日常零星活兒
chorus	n.合唱隊[C]；合唱[C]；副歌[C]
cigar	n.雪茄
cinema	n.【英】電影院[C]
circula	a.圓形的；環形的
circulate	vt.vi.循環；流通；發行
circulation	n.循環；(貨幣、消息
circumstance	n.情況，環境
civilian	n.(與軍、警相對的)平民，百姓
civilization	n.教化(過程)[U]；
Clarify	vt.vi.澄清；闡明
clash	n.vi.vt.砰地相碰撞；衝突
classification	n.分類；分級
classify	vt.將...分類；將...分等級
cliff	n.(尤指海邊的)懸崖，峭壁
climax	n.頂點，高潮
clumsy	a.笨拙的，手腳不靈活的
coarse	a.粗糙的；粗劣的
code	n.法典，法規；規則；代碼；密碼
collapse	vi.vt.n.倒塌
combination	n.結合(體)；密碼鎖
comedy	n.喜劇
comic1	a.喜劇的 n.喜劇演員
comic(s)2	a.連環漫畫的 n.連環漫畫
commander	n.指揮官，司令官
comment	n.vi.註釋，評註；批評，評論
commerce	n.商業，貿易 [U]
commit	vt.犯(罪)，做(錯事等)
communication	n.溝通；傳達；
community	n.社區[C]；
companion	n.同伴，伴侶
competition	n.競爭，比賽，競賽
competitive	a.競爭的；競爭激烈的
competitor	n.競爭者；對手
complicate	vt.使複雜化
compose	vt.作(詩，曲等)；組成(+of)
composer	n.作曲者，作曲家
composition	n.寫作；作曲[U]；
concentrate	vt.集中；聚集；濃縮
concentration	n.集中；專心；濃縮
concept	n.概念，觀念
concerning	prep.關於...
concrete	a.有形的；具體的 n.混凝土
conductor	n.管理人；指揮；車掌；
conference	n.(正式)會議
Confess	vt.坦白，承認[+v-ing][+(that)
Confidence	n.自信，信心[U]
Confine	vt.限制；使局限[(+to)]
confusion	n.混亂；慌亂；困惑
congratulate	vt.祝賀；恭禧
congress	n.(正式)會議；代表大會；
Conjunction	n.【文】連接詞；結合
conquer	vt.征服；攻克，攻取
conscience	n.良心；道義心
consequence	n.結果，後果[C][
consequent	a.隨之發生的
conservative	a.保守的，守舊的
consist	vi.由..組成[(+of)]；在於... [(+in)]
consistent	a.始終如一的，前後一致的
consonant	n.【語】子音；子音字母[C]
constitute	vt.構成，組成
constitution	n.憲法；章程[C]
construct	vt.建造，構成
construction	n.建造，建設
constructive	a.建設性的；結構上的
consult	vt.與...商量；請教；
consultant	n.顧問
consume	vt.消耗，花費
consumer	n.消費者；消耗者
container	n.容器(如箱、盒、罐等)
content	a.滿足的，滿意的 vt.滿足 n.滿足
content(s)	n.含量；內容
contentment	a.滿足，知足；滿意[U]
contest	n.爭奪，競爭，比賽
context	n.【語】上下文
continual	a.不間斷的，連續的
continuous	a.連續的，不斷的
contrary	n.相反；相反的事物
contrast	n.對比，對照[U] vi.
Contribute	vt.vi.捐(款)；捐獻；投(稿)
contribution	n.貢獻；投稿
convenience	n.方便[U]；便利設施[C]
convention	n.大會；全體與會者[C]；
conventional	a.會議的；慣例的
converse	vi.【書】交談
convey	vt.運送；傳遞[(+from/to)]
convince	vt.使信服；說服[(+of)]
cooperate	vt.合作，協作[(+with/in)]
cooperation	n.合作，協力[U]；
cooperative	a.合作的；合作社的
cope	vi.對付，妥善處理[(+with)]
copper	n.銅[U]
cord	n.細繩，粗線；【解】腱，韌帶
cork	n.軟木[U]；軟木塞[C]
correspond	vi.符合，一致；通信
costume	n.戲裝[U][C]
cottage	n.農舍，小屋
council	n.會議；地方議會[C]
count?r	n.計算者；櫃臺
count?r	a.n.相反(的)；反對(的)
courageous	a.英勇的，勇敢的
courteous	a.殷勤的，謙恭的
courtesy	n.禮貌；殷勤，好意
crack	vi.vt.(使)爆裂，(使)破裂 n.裂縫
craft	n.工藝，手藝；船；飛機；
cram	vt.把...塞進[(+into)]；把...塞滿；
creation	n.創造；創作[U]；創作品[C]
creativity	n.創造力
cripple	n.跛子；殘廢的人 vt.使...殘廢
critic	n.批評家，評論家
critical	a.緊要的，關鍵危急的；
criticism	n.批評；評論
criticize	vt.vi.批評；批判
cruelty	n.殘酷，殘忍[U]
crush	n.vt.vi.壓碎，壓壞；碾碎 n.迷戀
cube	n.立方體；方塊；三次方
cucumber	n.黃瓜，胡瓜[C]
cue	n.【戲】提示；信號 vt.給...暗示
cunning	a.狡猾的，奸詐的
curiosity	n.好奇心[U]
curl	n.卷毛，卷髮[C] vt.vi.捲曲
curse	n.vt.vi.詛咒，咒罵
curve	n.曲線，弧線；【棒】曲球 vi.彎曲
cushion	n.坐墊；靠墊；避震器
damn	vt.罵...該死，咒罵 int.該死
damp	a.有濕氣的；潮濕的
deadline	n.截止期限，最後限期
declare	vt.宣布，宣告；聲明[+(that)]；
Decoration	n.裝飾[U]；裝飾品[C]
decrease	vt. n.減；減少，減小
defeat	vt.n.戰勝，擊敗；失敗，挫敗
defend	vt.防禦;保衛；為...辯護；【體】防守
defense	n.防禦，保衛；辯護；【體】防守
defensible	a.可防禦的；可辯護的
defensive	a.防禦的；保護的；保衛的
definite	a.明確的，確切的
delicate	a.易碎的；嬌貴的；精美的
delight	n.欣喜 [U]；樂事 [C] vt.使...高興
delightful	a.令人愉快的，令人高興的
demand	n.vt.要求，請求[C][(+for)]
demonstrate	vt.(用實驗、實例等)證明；
demonstration	n.(用實驗，實例等)
dense	a.密集的，稠密的
depart	vi.【書】起程，出發；離開，離去
departure	n.離開；出發，起程
dependable	a.可靠的；可信任的
dependent	a.依靠(賴)的；取決於...的
depress	vt.使...沮喪，使...消沉；使...蕭條
depression	n.沮喪，消沉；不景氣，蕭條
deserve	vt.應受，該得 [+to-v]
desperate	a.情急拼命的；極度渴望的
despite	n.惡意；怨恨
destruction	n.破壞；毀滅
detective	n.偵探；私家偵探 a.偵探的
determination	n.堅定；果斷；決心
device	n.設備，儀器，裝置
devise	vt.設計；發明；策劃
devote	vt.將...奉獻(給)[(+to)]
diaper	n.【美】尿布[C]
differ	vi.不同，相異[(+from)]
digest1	vt.消化(食物)；領悟，融會貫通
digest2	n.摘要；文摘[C]
digestion	n.消化；(知識等的)領悟[U]
digital	a.數位的；數字的
dignit	n.尊嚴；莊嚴[U]
diligence	n.勤勉，勤奮
diploma	n.畢業文憑，學位證書
diplomat	n.外交官
disadvantage	n.不利；損害
disaster	n.災害，災難，不幸[C][U]
discipline	n.紀律，風紀；教養[U]
disconnect	vt.使分離，分開
discourage	vt.使洩氣；勸阻
discouragement	n.沮喪，氣餒[U]；
disguise	n.vt.假扮，偽裝
disgust	n.作嘔；厭惡 vt.使作嘔
dismiss	vt.讓...離開；解散；不考慮
disorder	n.混亂，無秩序[U]
dispute	n.vt.vi.爭論；爭執
distinct	] a. 與其他不同的，有區別的
distinguish	vt.vi.區別；識別
distinguished	a.卓越的；著名的
distribute	vt.分發；分配
distribution	n.分發；配給物
district	n.區，行政區；地區，區域
disturb	vt.vi.妨礙，打擾
divine	a.神的，神性的
divorce	n.vt.vi.離婚
dominant	a.佔優勢的，支配的dominate
dormitory	n.學生宿舍(dorm)
download	vt.下載
doze	vi.n.打瞌睡，打盹
draft	n.草稿[C]；【美】徵兵[U]
dread	vt.vi.懼怕；擔心[+to-v][+v-ing][+(that)]
drift	vi.vt.n.漂，漂流
drill	vt.vi.鑽(孔)；在...上鑽孔；操練；訓練
durable	a.經久的，耐用的
dusty	a.滿是灰塵的，灰塵覆蓋的
dye	n.染料，染色[C][U] vt.vi.染(色)
dynamic	a.力學的；有活力的
dynasty	n.王朝；朝代[C]
earnest	a.認真的；誠摯的 n.認真，誠摯[U]
earphone	n.耳機；聽筒
economic	a.經濟上的；合算的
economical	a.經濟的，節約的 economics
economist	n.經濟學者；節儉的人
economy	n. 經濟(情況)；節約；經濟艙
efficiency	n.效率；效能
elastic	a.有彈性的，有彈力的
electrician	n.電工
electronics	n.電子學
elegant	a.雅緻的，優美的
elementary	a.基本的；初級的，基礎的
eliminate	vt.排除]；(比賽中)淘汰
elsewhere	adv.在別處；往別處
e-mail/email	n.【電腦】電子郵件
embarrass	vt.使窘；使不好意思
embarrassment	n.窘；難堪[U]；
embassy	n.(常大寫)大使館[C]
emerge	vi.浮現；出現[(+from/out of)]
emotional	a.感情(上)的；易動情的
emphasis	n.強調，重視，重點
empire	n.帝國[C]；大企業[C]
enclose	vt.圍住；圈起
encounter	n.vt.遭遇(敵人)；遇到(困
endanger	vt.危及；使遭到危險
endure	vt.忍耐，忍受；容忍
enforce	vt.實施，執行
enforcement	n.實施，執行；強制
engineering	n.工程；工程學[U]
enlarge	vt.放大；擴大；擴展
enlargement	n.放大；擴大；擴展
enormous	a.巨大的，龐大的
entertain	vt.娛樂；招待，款待
entertainment	n.娛樂；餘興；演藝
enthusiasm	n.熱情，熱忱
envious	a.嫉妒的；羨慕的[(+of)]
equality	n.相等；平等；【數】等式
equip	vt.裝備，配備[(+for/with)]
equipment	n.配備，裝備；設備；器械
era	n.時代；年代
errand	n.差事，差使
escalator	n.電扶梯
essay	n.論說文；散文
essential	a.必要的，不可缺的[(+to/for)]；
Establish	vt.建立，設立；確定，證實
establishment	n.建立，設立[U]；
estimate	vt.vi.n.估計，估量
evaluate	vt.估...的價；對...評價evaluation
eve	n.(通常大寫)(節日等的)前夜，前夕
eventual	a.最終發生的；最後的
evidence	n.證據；證詞；證人；物證
evident	a.明顯的；明白的
exaggerate	vt.vi.誇張，誇大
examinee	n.應試者；受檢查者
examiner	n.主考人；檢查人；審查員
exception	n.例外[C]；除外，除去
exhaust	vt.用完，耗盡；使精疲力盡
exhibit	n.vt.展示，陳列；(在法庭)提出(證據)
expand	vt.vi.展開，張開(帆，翅)；使膨脹
expansion	n.擴展；擴張；膨脹[U]
explanation	n.說明，解釋[U][C]
explore	vt.vi.探測；探勘；探索
explosion	n.爆發；爆炸；擴張，劇增
explosive	a.爆炸(性)的 n.爆炸物；炸藥
expose	vt.使暴露於；使接觸到；揭發
exposure	n.暴露；暴曬[U]；揭發
extend	vt.vi.延長，延伸；擴大，擴展
extent	n.廣度，寬度；程度；限度；範圍
facial	a.臉的；面部的 n.臉部按摩
facility	n.能力，技能[U]；設備，設施[C]
faithful	a.忠實的；忠誠的
fame	n.聲譽，名望 [U]
fantastic	a.【口】極好的，了不起的；
Fantasy	n.空想；幻想；夢想；空想的產物
farewell	int.再會！別了! n.告別 a.告別的
fatal	a.命運的；致命的，生死攸關的
favorable	a.贊同的；有利的，適合的
feast	n.盛宴，筵席
ferry	n.渡輪
fertile	a.(動植物)多產的；(土地)肥沃的
fetch	vt.去拿...；(去)拿來
fiction	n.(總稱)小說[U]；虛構，想像[U]
fierce	a. 兇猛的；殘酷的；猛烈的，激烈的
finance	n.財政；金融；財政學[U]
financial	a.財政的；金融的；金融界的
firecracker	n.爆竹，鞭炮[C]
fireplace	n.壁爐[C]
flee	vi.vt.逃，逃走
flexible	a.可彎曲的；有彈性的；可變通的
fluent	a.流利的，流暢的
flunk	vt.vi.使(某人)不及格；通不過(考試等)
flush	vi.湧；湧流；(臉)發紅
foam	n.泡沫；滅火泡沫[U] vi.起泡沫
forbid	vt.禁止，不許[+v-ing]
forecast	n.vt.vi.預測，預報
formation	n.形成，構成；構成物；隊形
formula	n.慣用語句；慣例；配方，處方；
fort	n.堡壘，要塞
fortunate	a.幸運的，僥倖的
fossil	n.化石；頑固不化的人
foundation	n.建立，創辦；基礎；基本
founder	n.創立者；奠基者
fragrance	n.芬芳；香味；香氣
fragrant	a.香的，芳香的
frame	n.架構，骨架；結構；框架，框子
freeway	n.【美】高速公路
frequency	n.頻率，次數
freshman	n.(大學等的)一年級生；新人
frost	n.霜 vt.vi.結霜
frown	vi.vt.n.皺眉；表示不滿
frustration	n.挫折，失敗
fuel	n.燃料 vt.vi.對...供給燃料；激起；刺激
fulfill	vt.執行(命令等)；履行(諾言等)；
fulfillment	n.完成，履行；實現
functional	a.機能的
fundamental	a.基礎的；根本的
funeral	n.葬禮；葬儀
furious	a. 狂怒的；狂暴的，猛烈的
furnish	vt.給(房間)配置(傢俱等)；裝備；供應
furthermore	adv.而且，此外
gallery	n.畫廊，美術館
gangster	"n.(結成團伙的)歹徒，匪盜,流氓"
gaze	vi.n.凝視，注視，盯
gear	n.齒輪；傳動裝置；(汽車)排檔；工具；
gene	n.【生】基因，遺傳因子
generation	"n.世代，一代；產生,發生"
generosity	n.寬宏大量；慷慨
genius	n.天資，天賦 [U]；天才，英才[C]
genuine	a.真的，非偽造的；真誠的
germ	n.細菌；微生物
gifted	a.有天資的，有天賦的
gigantic	a. 巨大的；巨人的
giggle	n.vi咯咯地笑；傻笑[(+at)]
ginger	n.薑；【口】精力，活力
glide	n.vt.vi.滑動，滑行
glimpse	n.vi.vt.瞥見；一瞥
globe	n.球；球狀物；地球儀
glorious	a.光榮的，榮耀的
goods	] n.商品；貨物
grace	n.優美；優雅；(票據到期後的)寬限[U]；
graceful	a.優美的，雅緻的
gracious	a.親切的；和藹的；慈祥的
graduation	n.畢業[U]；畢業典禮[C]
grammar	n.文法[U]
grammatical	a.文法的；文法正確的
grapefruit	n.葡萄柚
grateful	a.感謝的，感激的
gratitude	n.感恩，感謝
grav?	a.重大的；嚴重的；嚴肅的，認真的
greasy	a.油汙的，油膩的；油滑的
greeting(s)	n.問候，招呼；(生日等的)祝願詞
grief	n.悲痛，悲傷
grieve	vt.vi.(使)悲傷；(使)苦惱
grind	vt.vi.磨(碎)；碾(碎)
guarantee	n.保證；商品保證；保證書
guilt	n.有罪；犯罪；過失；內疚
guilty	a.有罪的，犯...罪的[(+of)]
gulf	n.海灣
habitual	a.習慣的，習以為常的
halt	n.vt.vi.暫停，停止；終止
handwriting	n.筆跡；書寫；手寫
harden	vt.vi.(使)變硬；(使)變堅固
hardship	n.艱難，困苦
hardware	n.金屬器件，五金器具；
Harmonica	n.口琴
harmony	n.和睦；和諧；和聲
harsh	a.粗糙的；刺耳的；澀口的；刺鼻的
haste	n.急忙，迅速
hasten	vt.vi.催促；加速
hatred	n.憎恨，增惡；敵意
headphone(s)	n.頭戴式耳機
healthful	a.有益於健康的
helicopter	n.直升機
herd	n.畜群；牧群
hesitation	n.躊躇，猶豫
highly	adv.非常，很，高度地
homeland	n.祖國；故國；家鄉
honeymoon	n.蜜月(假期、旅行)
honorable	a.可尊敬的；高尚的；光榮的
hook	n.鉤，掛鉤，魚鉤；鉤拳；鉤射
hopeful	a.有希望的；有前途的
horizon	n.地平線；眼界；
horrify	vt.使恐懼，使驚懼
hose	n.軟管；(軟)水管
host	n.主人；旅館老板；(廣播，電視的)節目
hostel	n.(青年)旅舍
household	n.一家人；家眷；家庭
housewife	n.家庭主婦
housework	n.家事[U]
humanity	n.人性；人道；(總稱)人；
humidity	n.濕氣，濕度[U]
hurricane	n.颶風，暴風雨
hydrogen	n.【化】氫[U]
iceberg	n.冰山；冷峻的人
identify	vt.確認；識別 vi.認同...
idiom	n.慣用語；成語
idle	a.閒置的；空閒的；懶惰的；無所事事的
idol	n.偶像；受崇拜之人(或物)
illustrate	vt.(用圖，實例等)說明，闡明
imaginable	a.可想像得到的
imaginative	a.有想像力的
imitate	vt.模仿
imitation	n.模仿，模擬[U]；
Immigrant	n.(外來)移民，僑民[C]
immigrate	vi.遷移；遷入
immigration	n.移居；
impact	vt.vi.衝擊，撞擊
imply	vt.暗指；暗示
impression	n.印象[C][U][(+on)]
incident	n.事件；事變[C]；插曲[C]
including	prep.包括；包含
indication	n.指示；指點；徵兆；跡象
industrialize	vt.vi.(使)工業化
infant	n.嬰兒
infect	vt.【醫】傳染；感染
infection	n.傳染；侵染[U]
inflation	n.通貨膨脹[U][C]；充氣；膨脹[U]
influential	a.有影響力的；有權勢的
information	n.消息；情報；資訊[U]；詢問處
informative	a.教育性的；見聞廣博的
ingredient	n.(烹調的)原料；
initial	a.開始的，最初的
innocence	n.無罪；清白；天真無邪，純真
input	n.vt.投入；輸入
insert	vt.插入；嵌入
inspection	n.檢查，檢驗
inspiration	n.靈感[U]；鼓舞人心的人(或事物)[C]
inspire	vt.vi.鼓舞，激勵
install	vt.安裝，設置
instinct	n.本能；天性[(+to-v)]；直覺
instruct	vt.指示，命令；教授；訓練
instructor	n.教員；指導者；
insult	vt.侮辱，羞辱 [ˋ?ns?lt]n.
insurance	n.保險；保險契約[U]
intellectual	a.智力的；理智的
intelligence	n.智慧；情報 [U]
intelligent	a.聰明的；明智的
intend	vt.想要；打算[+to-v][+v-ing][+(that)]
intense	a.強烈的，劇烈的；熱情的
intensify	vt.vi.加強，增強
intensity	n.(思想、感情、活動等的)強烈；
intensive	a.加強的；密集的
intention	n.意圖，意向，目的
interact	vt.vi.互動； 互相作用
interaction	n.互動； 互相作用
interfere	vt.vi.妨礙；衝突[(+with)]
intermediate	a.中間的，中等程度的
internet	n.【電腦】網際網路(internet)
interpret	vt.vi.解釋，說明，詮釋；口譯
intonation	n.語調；聲調
invade	vt.vi.侵入，侵略；侵犯
invasion	n.侵入，侵略；侵犯
invention	n.發明，創造[U]；
invest	vt.vi.投(資)[(+in)]
investment	n.投資；投資額
investigation	n.研究；調查
involve	vt.使捲入，連累；牽涉[(+in/with)]
involvement	n.捲入，連累；牽涉
isolate	vt.vi.使孤立；使脫離
isolation	n.隔離；孤立;脫離；【物】絕緣
itch	n.vi.vt.(發)癢
jealousy	n.妒忌；猜忌
junior	a.年紀較輕的；資淺的；
keen	a.熱心的，熱衷的；渴望的；敏銳的
knuckle	n.指(根)關節
labor	n.勞動[U]；勞工 [U]；陣痛[U] vi.勞動
laboratory	n.實驗室，研究室(lab)
lag	n.vi.vt.走得慢；落後；延遲
landmark	n.地標，陸標；
landscape	n.(陸上的)風景，景色[C]
landslide	n.山崩；土石流(mudslide)
largely	adv.大部分；主要地
lately	adv.最近，近來
launch	vt.n.使(船)下水；發射；投擲；使升空
lawful	a. 合法的；法定的
lead2	vt.vi.n.引導；領(路) [l?d] n.鉛[U]
le?n	n.vi.vt.傾斜；倚，靠
le?n	a.瘦的；無收成的
learned	a.有學問的，博學的
learning	n.學習；學問
lecture	n.授課；演講；訓話，告誡
lecturer	n.講演者
legend	n.傳說；傳奇故事；傳奇人物[C]
leisurely	a.從容不迫的，悠閒的
license	n.執照，牌照；許可證
lighten	vt.vi.變亮；發亮
limitation	n.限制，極限，限度
liquor	n.酒；含酒精飲料[U][C]
literary	a.文學的，文藝的；文言的
literature	n.文學；文獻[U]
loan	n.借出；貸款[C]
locateon	n.位置；場所，所在地[C]
locker	n.(體育館等公共場所的)衣物櫃
logic	n.邏輯；邏輯學
logical	a.合邏輯的；合理的
lotion	n.(化妝等用的)化妝水，護膚液
lousy	a.【俚】不潔的；卑鄙的；討厭的
loyal	a.忠誠的，忠心的
loyalty	n.忠誠；忠心[U]
lunar	a.月的；月球上的；陰曆的
luxurious	a.奢侈的；驕奢淫逸的
luxury	n.奢侈，奢華[U]；奢侈品[C]
machinery	n.機器；機械 [U]
madam	n.(對婦女的敬稱)夫人，太太；
magnetic	a. 磁鐵的；磁性的，有魅力的
magnificent	a.壯麗的，宏偉的
makeup1	n.虛構
makeup2	n.化妝品；補充；補考
manual	n.手冊，簡介 a.手的；手工的
manufacture	vt.vi.(大量)製造，加工
manufacturer	n.製造業者，廠商
marathon	n.【體】(可大寫)馬拉松賽跑
margin	n.邊，邊沿，邊緣
maturity	n.成熟；完善
maximum	n.最大量，最大數
measur?	vt.測量；計量
mechanic	n.機械工，技工
mechanical	a.機械的，用機械的
memorable	a.值得懷念的；難忘的
memorial	n.紀念物；紀念碑；紀念館
mercy	n.慈悲，憐憫；仁慈，寬容
mere	a.僅僅的，只不過的
merit	n.長處，優點[C]；功績，功勞[C]
messenger	n.送信人；(電報郵件的)信差
messy	a.凌亂的; 雜亂的; 邋遢的
microscope	n.顯微鏡[C]
mild	a.溫和的，溫柔的
mineral	n.礦物；礦泉水 a.礦物的
minimum	n.最小量，最小數[C]
minister	n.部長；大臣；牧師
ministry	n.(常大寫)(政府的)部
mischief	n.頑皮，淘氣；胡鬧[U]
miserable	a.不幸的；悲哀的
misfortune	n.不幸[U]；不幸的事[C]
mislead	vt.誤導；把...引入歧途
misunderstand	vt.誤會；曲解
moderate	a.適度的；有節制的；溫和的
modest	a.謙虛的，審慎的
modesty	n.謙遜，虛心[U]
monitor	n.監視器；(學校的)班長，級長
monthly	a.每月的；每月一次的 adv.每月
monument	n.紀念碑，紀念塔，紀念館
moreover	adv.並且，加之，此外
mostly	adv.大多數地，大部分地
motivate	vt.給...動機；刺激；激發
motivation	n.動機；刺激；推動
mountainous	a.多山的；有山的
mow	vt.vi.(用鐮刀等)刈(草等)
muddy	a.多爛泥的；泥濘的
multiple	a.複合的；多樣的
murderer	n.謀殺犯，兇手
murmur	n.低語聲；輕柔持續的聲音
mustache	n.髭，小鬍子
mutual	a.相互的，彼此的；共有(同)的
mysterious	a.神祕的；不可思議的
namely	adv.即，那就是
nationality	n.國籍
nearsighted	a.近視的；目光短淺的
needy	a.貧窮的
neglect	vt.n.忽視，忽略
negotiate	vt.vi.談判，協商
nevertheless	adv.不過，然而
nightmare	n.夢魘；惡夢
nonsense	n.胡說；胡鬧 int.胡說!廢話！
noun	n.【文】名詞
nowadays	adv.現今，時下
nuclear	a.核心的，中心的；原子核的
numerous	a.許多的，很多的
nursery	n.幼兒室，育兒室；苗圃；養魚場
nylon	n.尼龍[U]
obedience	n.服從，順從[U]
obedient	a.服從的，順從的
objection	n.反對；異議
objectiv?	a.客觀的，無偏見的
objectiv?	n.目的，目標
observation	n.觀察；觀測
obstacle	n.障礙(物)；妨礙[C][(+to)]
obtain	vt.得到，獲得
occasional	a.偶爾的，非經常的
occupation	n.佔領[U]；職業[C]
occupy	vt.佔領，佔據
offend	vt.冒犯；觸怒
offense	n.罪過；犯法(行為)[C]；進攻，攻擊
offensive	a.冒犯的；進攻的
opera	n.歌劇[C]；歌劇院[C]；歌劇藝術[U]
operation	n.操作；運轉[U]；手術[C]
oppose	vt.vi.反對；反抗
oral	a.口頭的，口述的
orbit	n.(天體等的)運行軌道
orchestra	n.管弦樂隊[C
organic	a.有機體的，生物的；器官的
otherwise	"adv.否則,不然；用別的方法"
outcome	n.結果；結局
outstanding	a.顯著的；傑出的
oval	n.卵形(物)[C] a.橢圓形的
overcome	vt.vi.戰勝；克服
overlook	vt.vi.眺望，俯瞰；看漏，忽略
overnight	a.adv.整夜；一夜間，突然
overtake	vt.vi.追上；趕上；超車
overthrow	vt.vi.打倒；推翻
oxygen	n.【化】氧；氧氣[U]
pace	n.一步； 步速；速度 vi.踱步，慢慢地走
panel	n.嵌(鑲)板；【機】控制板；專門小組
parachute	n.降落傘
paragraph	n.(文章的)段，節
partial	a.部分的，局部的；不公平的，偏袒的
participation	n.參加，參與
participle	n.【文】分詞[C]
partnership	n.合夥(或合作)關係[U]
passive	a.被動的；消極的
pasta	n.麵糰；義大利麵(包括通心粉，細麵條等)
pebble	n.小卵石[C]
peculiar	a.奇怪的；乖癖的
pedal	n.踏板；腳蹬
peer	n.(地位，能力等)同等的人；同輩
penalty	n.處罰；刑罰[U][C][(+for)]
percent	n.百分之一[C]；百分率(per cent)
percentage	n.比例；部分
perfection	n.完美
perfume	n.香水；香料
permanent	a.永久的，永恆的 n.燙髮
persuasion	n.說服，勸說[U]
persuasive	a.勸說的；有說服力的
petal	n.花瓣
phenomenon	n.現象[C]
philosopher	n.哲學家
philosophical	"a.哲學的,冷靜的,哲學上的"
philosophy	n.哲學[U]；人生觀；主義[U][C]
photography	n.攝影術[U]
physical	a.身體的，肉體的；物理(學)的
physician	n.醫師；內科醫生 (doctor)
physicist	n.物理學家
physics	n.物理學
pianist	n.鋼琴家；鋼琴演奏者
pickpocket	n.扒手
pioneer	n.拓荒者；先驅者
pirate	n.海盜；劫掠者；剽竊者；盜版者
plentiful	a.豐富的，充足的
plot	n.陰謀；祕密計畫；(小說，戲劇等的)情節
plural	n.複數[U] a.【文】複數的
poisonous	a.有毒的；有害的
polish	vt.vi.磨光，擦亮 n.磨光粉；擦亮劑
pollution	n.汙染
popularity	n.普及；大眾化；聲望
portable	a.手提式的；輕便的
porter	n.(車站，機場等的)搬運工人，腳夫
portray	vt.畫(人物，風景等)；(用語言)描寫
possess	vt.擁有，持有；具有；佔有
possession	n.擁有；佔有[U]；所有物；財產
precise	a.精準的；確切的；恰好的
predict	vt.vi.預言；預料；預報
preferable	a.更好的，更合意的[(+to)]
pregnancy	n.懷孕
pregnant	a.懷孕的，懷胎的
preposition	n.【文】介系詞，前置詞
presentation	n.贈送；顯示；演出
preservation	n.保護；保存；防腐
preserve	vt.vi.保存，保藏；維護
prevention	n.預防，防止[U]
prime	a.最初的；原始的；主要的；首位的
primitive	a.原始的；遠古的
privacy	n.私下；私事；私生活；隱私[U]
privilege	n.特權；優特
procedure	n.程序；手續；步驟
proceed	vt.vi.繼續進行；開始，著手
production	n.生產；製作[U]
productive	a.生產的；多產的；肥沃的
Professional	n.職業選手；專家，內行
professor	n.教授
profitable	a.有利的，贏利的；有益的
prominent	a.突出的；顯著的；卓越的
promising	a.有希望的，有前途的
promotion	n.晉級；發揚；提倡；促銷[U]
prompt1	a. 敏捷的，及時的，迅速的
prompt2	vt.. 促使；激勵；慫恿
pronoun	n.【文】代名詞
pronunciation	n.發音；發音法
prosper	vi.vt.(使)繁榮，(使)昌盛；(使)成功
prosperity	n.興旺，繁榮，昌盛，成功[U]
prosperous	a.興旺的，繁榮的，昌盛的
protein	n.蛋白質
protest	vi.抗議，反對 [ˋprot?st] n.
proverb	n.諺語，俗語
psychological	a.心理學的
psychologist	n.心理學家
psychology	n.心理學[U]
publication	n.出版；發行[U]；
publicity	n.(公眾的)注意，名聲；宣傳
publish	vt.vi.出版；發行
publisher	n.出版(或發行)者
pursuit	n.追蹤，追擊；追求，尋求[U][(+of)]
quake	n.vi.顫抖，哆嗦；震動
quilt	n.被(子)；被褥
quotation	n.引用，引證[U]；引文；語錄[C]
rage	n.(一陣)狂怒，盛怒 vi.發怒，怒斥
rainfall	n.降雨，下雨
realistic	a.現實的，注重實際的；現實主義的
rebel	vi造反；反叛
recall	n.vt.vi.回想，回憶
reception	n.接收；接待；歡迎；接待會
recipe	n.食譜
recite	vt.vi.背誦；朗誦
recognition	n.認出，識別；認可[U]
recovery	n.重獲；恢復，復甦
recreation	n.消遣；娛樂
recycle	vt.使再循環；再利用
reduction	n.減少；削減；【數】簡化
refer	vt.把...歸因於；將...提交 [(+to)]
reference	n.提及；提交；參考
reflect	vt.vi.反射；思考，反省
reflection	n.反射；回響；深思，熟慮
reform	n.vt.改革，革新
refresh	vt.vi.(使)清新；消除(...)疲勞
refugee	n.難民；流亡者
refusal	n.拒絕[U][C][+to-v]
regarding	prep.關於；就...而論
register	n.vt.vi.登記，註冊
registration	n.登記，註冊，掛號[U]
regulate	vt.vi.管理；控制；校準；調節
regulation	n.規章；規則[C]；管理；調整
rejection	n.拒絕；退回；【醫】排斥[U]
relativ?	n.親戚，親屬；【文】關係詞
relativ?	a.相對的，比較的；
relaxation	n.鬆弛，放鬆[U]
relieve	vt.vi.緩和，減輕；解除
reluctant	a.不情願的；勉強的
remark	vi.n.談到；評論；說；注意；察覺
remarkable	a.值得注意的；非凡卓越的
remedy	n.治療；治療法；藥物
repetition	n.重複；反覆
representation	n.代表；代表權[U]；
reputation	n.名譽，名聲
rescue	n.vt.援救；營救
research	n.vi.vt.(學術)研究；調查，探究
researcher	n.研究員；調查者
resemble	vt.像，類似
reservation	n.保留(意見)；(公共)專用地；自然保護區；預訂；預訂的房間(或席座)
resign	vt.vi.放棄，辭職
resignation	n.辭職；放棄；辭呈[C]
resistance	n.抵抗，反抗，抵抗力；電阻
resolution	n.決心；決定[C][+to-v]；
resolve	vt.vi.決心，決定；解決;解答；議決
respectable	a.值得尊敬的
respectful	a.恭敬的；尊敬人的
restore	vt.vi.恢復；使復原；修復，整修
revenge	vt.替...報仇[(+on/upon)]
revise	vt.vi.修訂；校訂
revision	n.修訂；修訂本，訂正版[C]
revolution	n.革命；(天體的)運行，公轉
revolutionary	a.革命的
reward	n.vt.報答；報償；獎賞
rhyme	n.韻，韻腳 vi.押韻
rhythm	n.節奏；韻律[U]；節拍[C]
romance	n.愛情小說；浪漫情調[U]
roughly	adv.粗糙地；粗略地；大體上；大約
route	n.路；路線；航線[C]
ruin	n.毀滅；崩潰；毀壞[U]；廢墟；遺跡[C]
rural	a.農村的；田園的
sacrifice	n.(供神的)牲禮，祭品；犧牲
salary	n.薪資，薪水
salesperson	n.店員，售貨員(salesman)
saleswoman	n.女店員；售貨員
satellite	n.衛星；人造衛星
satisfaction	n.滿意，滿足
scarcely	adv.幾乎不，幾乎沒有
scenery	n.風景，景色 [U]
scold	vt.vi.n.罵，責罵
scratch	n.vt.vi.抓；搔；擦；刮
screwdriver	n.螺絲起子
sculpture	n.雕塑品；雕像[C]；雕刻術[U]
seagull	n.海鷗(gull)
senior	a.年長的，前輩的；四年級生的
settler	n.移居者；殖民者；(糾紛等的)解決者
severe	a. 嚴重的；劇烈的；嚴厲的；嚴肅的
shameful	a.可恥的，丟臉的
shaver	n.理髮師；刮鬍鬚的用具
shelter	n.遮蓋物；躲避處；避難所
shift	vt.vi.轉移；移動；變(速)，換(檔)
shortsighted	a.近視的；目光短淺的
shrug	n.vi.vt.(表示疑惑，蔑視，無奈等)聳肩
shuttle	n.(紡織機的)梭子；接駁車；太空梭；羽毛球
sightseeing	n.觀光，遊覽[U]
signature	n.簽名，簽署；(人物)識別標誌
significance	n.重要性，重要[U]
sincerity	n.真實；誠心誠意
singular	a.【文】單數的 n.【文】單數(形)
site	n.地點，場所；【電腦】網點
sketch	n.vt.vi.速寫，素描
sledge	n.雪橇 vi.乘雪橇 vt.用雪橇運送(=sled)
sleigh	n.雪橇 vi.乘雪橇 vt.用雪橇運送(=sled)
slight	a.輕微的；微小的；少量的
slogan	n.口號，標語
smog	n.煙霧(= smoke and fog)[U]
sneeze	vi.打噴嚏 n.噴嚏(聲)[C]
sob	vi.vt.n.嗚咽；啜泣
socket	n.托座，承口；【電】插座；插口
software	n.【電腦】軟體 [U]
solar	a.太陽的；日光的
sophomore	n.(大學，高中的)二年級學生
sorrowful	a.悲傷的，傷心的
souvenir	n.紀念品，紀念物
spare	vt.分出，騰出(時間，人手)；節約
spark	n.火花，火星 vt.發動；點燃
sparkle	n.火花；閃耀，閃光
sparrow	n.麻雀
spear	n.矛；魚叉
species	n.種類；【生】物種
spicy	a.加有香料的；香的；辛辣的
spiritual	a.精神(上)的，心靈的
splendid	a.有光彩的；燦爛的；極好的
split	vt.vi.劈開；切開
sportsman	n.喜好運動的人；運動員
sportsmanship	n.運動員精神
status	n.地位，身分；情形，狀況
stem	n.莖，(樹)幹，(葉)柄
stingy	a.吝嗇的，小氣的
strengthen	vt.vi.加強；增強；鞏固
strive	vi.努力，苦幹，奮鬥
stroke	n.打，擊，敲；(病)突然發作；
stroke	vt.n.(用手)撫，摸，捋
submarine	n.潛水艇 a.海底的
suggestion	n.建議，提議；暗示
summarize	vt.vi.總結，概述
surf	vt.vi.衝浪；快速瀏覽
surgeon	n.外科醫生
surgery	n.外科，(外科)手術[U]；手術室
surrender	vi.vt.n.投降，自首
surroundings	n.環境；周圍的事物
suspicious	a.猜疑的，可疑的
sway	vt.vi.n.搖動，搖擺
syllable	n.音節[C]
sympathetic	a.同情的；有同情心的
sympathy	n.同情，同情心
symphony	n.交響樂，交響曲
syrup	n.糖漿；果汁
systematic	a.有系統的；有條理的
tap	n.龍頭(酒桶等的)塞子，栓子；竊聽器
tap	n.vt.vi.輕拍，輕叩，輕敲
technician	n.技術人員，技師
technological	a.技術(學)的，工藝(學)的
telegram	n.電報
telegraph	n.電報
telescope	n.(單筒)望遠鏡
tendency	n.傾向；癖性；趨勢，潮流
tense	a.拉緊的，繃緊的
tension	n.拉緊，繃緊[U]；(精神上的)緊張[U]
terrify	vt.vi.使害怕，使恐怖
terror	n.恐怖，驚駭[U]；
theme	n.論題，話題；主題，主題思想
thorough	a.徹底的；完全的
thoughtful	a.深思的；細心的；體貼的
timid	a.膽小的，易受驚的
tiresome	a.使人疲勞的；令人厭倦的
tolerable	a. 可忍受的；可容忍的
tolerance	n.寬容，寬大[U]；忍耐(力)
tolerate	vt.vi.忍受；容忍
tolerant	a.忍受的，容忍的
tomb	n.墓；墓碑
tough	a. 堅韌的；強壯的；棘手的，費勁的
tragedy	n.悲劇體裁[U]；(一齣)悲劇[C]
tragic	a.悲劇的；悲慘的，不幸的
transfer	vt.vi.轉換；換車；轉校
transform	vt.vi.(使)改變；(使)改觀
translate	vt.vi.翻譯，轉譯
translation	n.翻譯[U]；譯文；譯本[C]
translator	n.翻譯員，翻譯者，翻譯家
transportation	n.運輸[U];運輸工具
tremendous	a.巨大的，極大的
triumph	n.(大)勝利；(大)成功[C]
troublesome	a.麻煩的，棘手的
tug-of-war	n.拔河(比賽)
twinkle	n.vi.(星等)閃爍；閃耀
typist	n.打字員；打字者
underpass	n.地下道；地下人行道
unique	a.唯一的，獨一無二的
universal	a.全體的；普遍的；一般的
university	n.大學
upload	vt.vi.【電腦】上傳
urban	a.城市的
urge	vt.vi.催促；力勸；慫恿
urgent	a.緊急的，急迫的
usage	n.使用，用法[U]
vain	a.愛虛榮的，自負的；徒然的，無益的
vast	a.廣闊的，廣大的，巨大的；巨額的
vegetarian	n.素食者；食草動物
verb	n.【文】動詞
very2	adv.非常，很 a.正是；恰好是
vessel	n.船，艦；容器，器皿；血管，脈管
vinegar	n.醋[U]
violate	vt.vi.違犯；違反；侵犯
violation	n.違反；違背[U]；違反行為[C]
virgin	"n.處女,未婚女子 a.處女的，貞潔的"
virtue	n.善，德[U]；美德，德行[C][U]
virus	n.病毒；濾過性病毒[C]
visual	a.視力的；視覺的；光學的
vital	a.生命的；維持生命所必需的
volcano	n.火山[C]
voluntary	a.自願的，志願的
volunteer	n.志願者，義工
vowel	n.【文】母音
voyage	n.航海，航行
walnut	n.胡桃；胡桃樹[C]
website	n.【電腦】網站
weekly	a.每週的；一週一次的
welfare	n.福利；幸福[U]
wit	n.機智；智慧[U]
witch	n.女巫，巫婆
wizard	n.男巫；術士
withdraw	vt.vi.抽回；收回；取回；提領(錢)
witness	n.目擊者；見證人 vt.目擊
wreck	n.(船等的)失事，遇難[U]；船難事故[C]
wrinkle	n.皺紋 vt.vi.(使)起皺紋
yearly	a.每年的，一年一次的
yogurt	n.酸奶酪；酵母乳 (yoghourt)
youthful	a.年輕的；青年的；富青春活力的
