word	meaning
abbreviate	縮寫，使省略[（+to）]；縮短，使簡短 使用縮寫詞
abide	（常用於否定句和疑問句）忍受，容忍；頂住 持續；【古】逗留，住[（+at/in）]
aboriginal	最早就有的；土著的；原始的；土著居民的 土著居民；土生動物（或植物）
abound	大量存在[（+in）]；富足[（+in）]
abstraction	抽象；抽象過程[U]；抽象概念；抽象名稱[C]
abundance	豐富；充足[U]；大量，多[S][（+of）]
academy	學院；大學；研究院[C]；科學院；藝術院[C]
accessory	附件，配件；附加物件；婦女飾品；房間陳設[P1] 附加的，附屬的；輔助的；同謀的，幫兇的
acclaim	向......歡呼；為......喝采；稱讚[O9]；（以歡呼聲）宣布；擁立[O9] 歡呼；喝采 歡呼；喝采；稱讚[U]
accordance	一致，和諧；符合；授予；給予
accordingly	照著；相應地；因此；於是
accountable	（對......）有解釋義務的；應負責任的；可說明的
accumulate	累積，積聚；積攢 積成堆；累積，聚積
accumulation	積累；積聚；堆積[U]；累積物；積聚的一堆[C]
accusation	指控，控告；指責[U][C][+（that）]；（被控告的）罪名[U][（+against）]
accustom	（常後接oneself或用被動式）使習慣（於）[（+to）]
acne	【醫】痤瘡；粉刺；面皰；青春痘
acre	英畝；地產；土地[P]
adaptation	適應，適合[U][S1]；改編，改寫；改寫本[U][C]
addiction	沉溺；成癮；上癮；入迷
administer/administrate	管理；掌管；經營；執行，實施
admiral	海軍上將；海軍將官；艦隊司令
adolescence	青春期，青少年時期；（文化等的）發育成形階段
advisory	顧問的，諮詢的；勸告的；忠告的 （尤指美國氣象局發布的）報告；公告[C]
aesthetic	美學的；美的；藝術的 美學；美學標準；審美觀[U]
affectionate	充滿深情的，溫柔親切的[（+to/towards/with）]；【廢】強烈傾向的；任性的[（+to）]
affiliate	使緊密聯繫[H][（+with）]；接納......為成員（或分支機構）；使隸屬於[H][（+to/with）] 發生聯繫，參加[（+to/with）]
affirm	斷言，申明，堅稱[+that]；證實，確認[（+as）] 斷言；【律】（不經宣誓而）提供正式證詞
airtight	密閉的；無懈可擊的
airway	（礦井的）風道，風巷；（肺的）氣道；（麻醉時用的）導氣管
algebra	代數學[U]；代數學課本；代數學論文
alienate	使疏遠；離間[（+from）]；【律】轉讓，讓渡（財產等）
align	把......排列（成一行），排成直線；使結盟；使密切合作
allege	（無充分證據而）斷言，宣稱[?][+（that）]；（作為理由，藉口或論據等）提出[（+as）][+（that）]
alligator	【動】（產於美國及中國的）短吻鱷[C]；短吻鱷皮（革）[U]
altitude	高，高度；海拔[S1]；高處，高地[P1]
aluminum	【美】鋁[U]
ambiguity	可作兩種（或多種）解釋；意義不明確[U]；模稜兩可的話；含糊話[C]
amid/amidst	在......之間；在......之中；被......包圍
amplify	放大（聲音等）；增強；擴大；擴展 發揮，詳述[（+on）]
analogy	相似，類似[C][（+between/to/with）]；比擬；類推，類比[U][S1]
analytical	分析的；善於分析的
anchor	錨；錨狀物；賴以支撐的人（或物），靠山 拋錨使（船）停泊；使固定，繫住 拋錨泊船；固定
animate	賦予生命，使有生命；使活潑，使有活力，使有生氣
annoyance	惱怒；煩惱；打擾[U]；使人煩惱的事；討厭的東西（或人）[C]
anthem	【宗】聖歌；（應答輪唱的）讚美詩；（對母校等的）頌歌；國歌
antibiotic	【生】抗生的；抗菌的 【微】抗生素，抗菌素
anticipation	預期，期望；預料[U][C]；預期的事物[C]
antonym	反義字[C]
applaud	向......鼓掌；向......喝采；稱讚；贊成 鼓掌歡迎；喝采
applicable	可應用的，合用的；可實施的；適當的，合適的[（+to）]
apprentice	學徒，徒弟；見習生 使當學徒 當學徒
approximate	近似的，接近的；大約的，大概的 接近，近似[L]；使接近[（+to）] 接近[（+to）]
archaeology	考古學
archive	檔案館，檔案保管處；資料庫；檔案；文件；記錄 把......存檔；把......收集歸檔
arithmetic	算術，計算[U]；算術知識（或技巧）[U] 算術的；根據算術的[Z]
ascend	登高；上升；追溯（到某個時間）[（+to）] 攀登；登上
aspire	熱望，嚮往；懷有大志[to/after][+to-v]
assassinate	暗殺，對......行刺；詆毀；破壞，糟蹋（名譽等）
asthma	【醫】氣喘（病），哮喘
astray	離開正確的路；迷路；離開正道；不對頭 迷路的；離開正道的；不對頭的
astronaut	太空人，宇航員；太空旅行者
astronomer	天文學家[C]
astronomy	天文學[U]
attain(ment)	達到；獲得；到達
attendant	陪從，隨員；服務員；侍者 侍候的；護理的；伴隨的[（+on/upon）]
audit	審計；查帳；決算 審核；查帳；【美】以旁聽生資格出席；旁聽
auditorium	聽眾席；觀眾席；會堂，禮堂
avert	避開，移開[（+from）]；防止，避免
aviation	航空，飛行；航空學，飛行術
awesome	令人敬畏的；可怕的；有威嚴的；感到敬畏（或畏懼）的
awhile	片刻；少頃
bachelor	單身男子，單身漢；鰥夫；（常大寫）學士
backbone	脊骨，脊柱 [C]；主（山）脈，幹脈
badge	徽章，證章；獎章；紀念章；標誌，標記；象徵 授給......徽章（或獎章等）
banquet	宴會，盛宴；宴請，款待 參加宴會 宴請，設宴款待
barbarian	野蠻人，未開化的人；粗野的人；殘暴的人 野蠻人的，未開化的；粗野的，殘暴的，野蠻的
bass	男低音[U]；男低音歌手[C] （聲音）低沉的；男低音的；（樂器）低音的
batter	連續猛擊，搗毀，打碎；磨損，把......用舊 作連續猛擊[Q][（+at/on/against）]
beautify	使更加美麗；美化 變得美
beep	嗶嗶的聲音；警笛聲 作嗶嗶聲；吹警笛
beforehand	預先，事先；提前地，超前地 預先準備好的；提前的；趕在前面的
beverage	飲料[C]
bilateral	有兩邊的；左右對稱的；雙方的；雙邊的 【律】對等契約
blaze	火焰；火災；熊熊燃燒；強烈的光，光輝 燃燒；閃耀 使燃燒；閃耀出；顯示出
bleach	將......漂白；將......曬得褪色 變白；脫色，變淡 漂白；漂白劑；漂白法
blond/blonde	（人的毛髮）亞麻色的，金黃色的
blot	墨水漬，汙漬[（+on）]；有損整體美的東西[（+on）] 塗汙，弄髒；汙損（名譽）；使蒙恥 弄上墨漬（或汙漬）；吸墨水
blunt	鈍的，不鋒利的；（頭腦，感覺等）遲鈍的 使鈍；使遲鈍；減弱 變鈍；變遲鈍
bodily	肉體的，身體的；物質上的；有形的；有軀體的 親身地；以肉體形式，活生生地；全體地，整體地
booklet	小冊子[C]
bosom	胸；懷；（女人的）乳房[P] 懷抱，擁抱；把......藏在心中 知心的，親密的
boulevard	林蔭大道；【美】大馬路
boxing	做箱（或盒）的材料；裝箱；裝盒
boycott	杯葛；聯合抵制；拒絕參加（或購買等）；一致與......絕交 杯葛；聯合抵制；拒絕參加[C]
brace	支柱；支撐物；大括號[P] 支撐；加固；使繃緊 鼓起勇氣[（+up）]；做好準備[（+for/against）]
breadth	寬度；幅度[C][U]；（布的）幅面；（船）幅[C]
breakdown	（機器等的）故障，損壞；垮臺，崩潰；破裂
breakup	中斷；中止；分離，分散，分裂
bribe	賄賂；行賄物，誘餌[C] 向......行賄；收買[（+with/into）][?] 行賄
brink	（懸崖，江河等的）邊，邊緣[the S][（+of）]；（死亡，危險，戰爭等的）邊緣[the S][（+of）]
broaden	變寬，變闊；擴大 使寬，使闊；使擴大
brochure	小冊子[C]
broil	烤，炙；使受到灼熱；曝曬 被烤（或炙）；受到灼熱；被曝曬 烤炙食品[U]；烤，炙；灼熱[C]
brook	小河，小溪
broth	（用肉、蔬菜等煮成的清淡的）湯[U][C]
brotherhood	兄弟關係；手足之情[U]；同志關係[U]
bulky	體積大的，龐大的；過大的；又大又笨的，笨重的
bureaucrat	官僚；官僚主義者
bypass	旁道，旁路；【機】旁通管 繞過，繞走；加設旁道（旁管）
caffeine	咖啡因，咖啡鹼
calculator	計算者；計算表
calligraphy	書法；筆跡
cape	岬，海角[C]
capsule	小盒，小容器；【藥】膠囊 概要的；濃縮的；微型的 概括，簡述；使濃縮
caption	標題；字幕；照片說明；逮捕 加標題於
captive	俘虜；囚徒；獵獲物；著迷的人；受控制的人 被俘的；受監禁的；受控制的；被迷住的
captivity	囚禁；被俘；束縛
cardboard	硬紙板，卡紙板[U] 硬紙板製的；扁而硬的；不真實的，不自然的；虛構的，沒有深度的，膚淺的
cardinal	重要的，主要的；基本的，根本的 （羅馬天主教的）紅衣主教，樞機主教[C]；深紅色，鮮紅色[U]
carefree	無憂無慮的；輕鬆愉快的
caretaker	照顧者，管理人；【英】看門人；（學校的）工友，雜務工 臨時代理的
carton	紙盒，紙板箱；蠟紙液體容器[C]；一紙盒（或紙板箱等）的量[C][（+of）] 用紙盒（或紙板箱等）裝 製作紙盒（或紙板箱等）
cashier	撤......的職，開除；丟棄
casualty	（軍隊的）傷亡人員[P1]；（事故、災難等的）死者；傷者；受害人[C]
catastrophe	大災，大禍，大災難；大敗，慘敗
cater	提供飲食；承辦宴席[（+for）]；滿足需要（或慾望）；迎合，投合[（+for/to）] 為......提供飲食，承辦（宴會等）的酒席
caterpillar	毛蟲，蠋（蝶、蛾的幼蟲）；履帶牽引車（諸如坦克之類）
cavity	洞，穴，凹處；（身體的）腔
celery	芹菜；（可供食用的）芹菜莖[U]
cellular	細胞組成的；劃分的；多孔的
Celsius	百分度的；攝氏的
cement	水泥；膠結材料；（牙科用來填補空洞的）黏固粉；白堊 用水泥接合[（+together）]；用水泥塗[（+over）] 黏緊，黏牢
census	人口普查；人口調查；（經調查而得的）統計數，記錄 對......進行人口普查；統計......的數目
ceramic	陶器的；製陶藝術的
certify	證明，證實[（+as）][?][O8][+（that）]；擔保；保證 證明；保證[（+to/for）]
chairperson/chair/chairman/chairwoman	議長；主席
champagne	香檳酒；香檳酒色（指淡橙黃色或淺褐黃色）
chant	歌；曲子；詠唱，吟誦 唱；反覆（單調）地唱（或說）；吟誦 唱歌；反覆（單調）地唱歌（或說話）；吟誦
charitable	慈悲為懷的；仁慈的[（+to）]；慈善的；施舍慷慨的
checkup	檢查；核對；體格檢查
chemist	化學家；【英】藥劑師，藥商
chestnut	栗子[C]；【植】栗樹[C] 栗色的
chili	紅番椒（一種墨西哥菜用的調味料）
chimpanzee	【動】黑猩猩
chirp	（小鳥）發啁啾聲；（昆蟲）發唧唧聲[（+away）]；嘁嘁喳喳地說話 尖聲尖氣地說（或唱）[（+out）]；咂嘴向......打招呼 啁啾聲；唧唧聲；嘎吱聲
cholesterol	【生化】膽固醇
cigar	雪茄菸
civilize	使文明，使開化；教化，薰陶；使文雅 變得文明（或文雅）
clam	蛤，蛤蜊，蚌[C]；（供食用的）蛤肉[U] 拾蛤，撈蛤，挖蛤；閉嘴不言；保持沉默[（+up）]
clasp	緊抱；緊握；扣住，扣緊；鉤住 扣住，扣緊；鉤住 扣子，鉤子，夾子[C]；擁抱；握手；緊握[S1]
clearance	清除，清掃；出空；空地；空隙
climax	頂點，最高點；高潮 使達到頂點（或高潮） 達到頂點（或高潮）
clockwise	順時針方向的；右旋的 順時針方向地；右旋地
clone	【植】克隆；無性繁殖系；翻版，複製品
closure	關閉；打烊；結束；終止 使結束；結束討論
coalition	結合，聯合[U]；（政黨、國家等）臨時結成的聯盟[C]
coastline	海岸線
collision	碰撞；相撞；（意見、利益等的）衝突，抵觸
colloquial	口語的；會話的；用於口語的；口語體的
comet	【天】彗星[C]
commonplace	司空見慣的事；老生常談；陳詞濫調 平淡無味的；平凡的，普通的；陳腐的
commonwealth	全體國民，全體公民[G]；政治實體，國家；共和國，民主國[C]
communicative	愛說話的；暢談的；愛社交的；愛交際的
comparative	比較的；用比較方法的；比較而言的，相對的 【語】比較級（或詞）[the S]
compass	羅盤，指南針[C]；（製圖用的）圓規[P1] 圖謀，計畫；圍繞......而行，包圍
compile	匯編；編輯；收集（資料等）
complement	補充物，補足物；配對物[（+to/of）]；足數；全數，整套
complexion	面色，膚色；氣色[C]；情況；樣子；性質[U] 使增添（或帶上）色彩
comprehensive	廣泛的；無所不包的；綜合的；有充分理解力的 （為獲得高一級學位必須通過的）專業綜合測驗，總考[P]；【英】綜合學校
compute	計算；估算；推斷 計算；估算；推斷 計算；估算；推斷[U]
computerize	使電腦化；用電腦處理
comrade	夥伴，戰友，同好，同事；（共產黨的）同志
concession	讓步；讓步行為[C]；讓予，給予[U]
concise	簡明的，簡潔的；簡要的
condense	壓縮；濃縮；聚集（光線） （氣體）冷卻成液體（或固體）；濃縮；凝結
confederation	同盟，聯盟；邦聯[C]；結盟，聯合[U][C]
congressman/congresswoman	美國國會議員
conquest	征服；克服；佔領[U]；（由征服所得的）掠奪物，繳獲品，佔領地[C]
conscientious	憑良心的；誠實的；認真的，勤勤懇懇的
conserve	保存；保護；節省；用糖保存，將......做成蜜餞
consolation	安慰，慰藉[U]；安慰的人（或事物）[C]
console	操縱臺；（電腦的）操作桌；（管風琴的）演奏臺；落地式收音機（或電視機等）；（收音機等的）落地櫃
consonant	【語】子音；子音字母[C] 符合的；一致的[（+with/to）]；（音調等）和協的
conspiracy	陰謀；謀叛；共謀[C][U][+to-v]；陰謀集團[C]
contention	論點，主張[C][+that]；爭論；爭吵；爭奪；競爭[U][S1][（+about/against/for/with/between）]
contestant	參加競賽者，角逐者；質疑者
continuity	連續性；持續性；連貫性[（+in/between）]；一連串，一系列[S1][（+of）]
contradict	否定（陳述等）；反駁；提出論據反對；與......矛盾；與......抵觸 否認；反駁；發生矛盾
convene	集會；聚集 召集（會議）；傳喚......出庭受審，票傳[（+before）]
coral	珊瑚[U]；珊瑚蟲[C] 珊瑚的；珊瑚製的；珊瑚色的，橘紅色的
corpse	屍體；殘骸
correspondence	一致；符合[U][（+with/to/between）]；相當；類似；相似處[C][（+between）]
cosmetic	化妝品；裝飾品[P] 化妝用的；化妝品的[B]；整容的[B]
cosmetics	化妝品，美容品；cosmetic的名詞複數
counterpart	極相像的人（或物）；互為補充的人（或物）；對應的人（或物），配對物
coupon	連張式的車票；聯票；贈券；減價優待券
courtyard	庭院；天井[C]
cowardly	膽小的，懦怯的；卑劣的 膽小地，懦怯地；卑怯地
cozy	舒適的；愜意的 保溫罩
crackdown	壓迫；鎮壓；痛擊
cracker	（淡或鹹的）薄脆餅乾；【美】餅乾；胡桃鉗[P]
cram	把......塞進[（+into）]；把......塞滿，把......擠滿[（+with）]；狼吞虎嚥地吃；塞飽[O] 狼吞虎嚥地吃東西；吃得過飽；【口】（為應考）死記硬背功課[（+up/for）] 擁擠[S]；死記硬背[U]
cramp	鐵夾鉗；夾鉗；鐵箍；約束物，束縛物；約束，束縛[（+on）] 用夾鉗夾緊；限制；約束；妨礙 狹窄的；受限制的；難懂的
crater	火山口[C]；（月環表面的）環形山[C] 使成坑 形成坑
credible	可信的；可靠的
crocodile	【動】鱷魚[C]；鱷魚皮革[U]
crossing	交叉；交叉點，十字路口[C]；渡口；（穿過街道等的）橫道[C]
crutch	丁形柺杖，（支在腋下的）撐拐；支撐物，支架；叉架 用撐拐支撐；支持 用撐拐支撐著行走
cub	（熊，獅，虎，狼等的）幼獸；幼鯨；幼鯊；（不成熟的）小青年，笨手笨腳的年輕人 生育幼獸；獵幼狐 生育（幼獸）
cucumber	黃瓜，胡瓜[C]
cultivate	耕種，耕作；栽培（作物等）；養殖（魚等）；培育
cumulative	漸增的；積蓄的；累計的；累計紅利的
curb	勒馬繩；控制，約束，抑制
curfew	晚鐘；戒嚴；宵禁
curry	咖喱；咖喱粉[U]；咖喱菜肴[C][U] 用咖喱燒；給......加咖喱粉[H]
customary	習慣上的，慣常的；合乎習俗的；【律】習慣法上的；按慣例的 （采邑、城市等的）習慣法匯編[C]
cynical	憤世嫉俗的；懷疑人間有真誠善意的；悲觀的[（+about）]；挖苦的，冷嘲的
dazzle	使目眩，使眼花；使昏昏然，使迷惑 耀眼的光；燦爛；令人讚歎（或迷惑）的東西
deafen	使聾；使聽不見；把......震聾
decisive	決定性的，決定的；確定的
dedication	奉獻，供奉[U]；獻堂典禮；揭幕儀式[C]
deduct	扣除，減除[（+from）]
deem	認為，以為；視作[+（that）][O8][O9] 持某種看法，作某種評價
default	不履行，違約，拖欠；不參加（比賽）；（中途）棄權 不履行，拖欠[（+on/in）]；不出場；不參加；不到案；棄權 不履行，拖欠；對......處以缺席裁判
defect	缺點，缺陷，不足之處[C] 逃跑，脫離，背叛[（+to/from）]
defiance	反抗；蔑視，藐視；挑戰
definitive	決定性的；最後的；限定的 【語】限定詞
dental	牙齒的；牙科的；齒音的 齒音[C]
deplete	用盡；使減少；耗盡......的資源（精力等）；使空虛[（+of）]
deprive	剝奪，從......奪走；使喪失[（+of）]；免去......的聖職（或職務）
descent	下降；下傾[U][C]；下坡[C]
despise	鄙視；看不起
destined	命中注定的；（場所）預定的
detach	分開，拆卸；使分離[（+from）]；派遣，分遣
detain	留住；使耽擱；拘留，扣留
detention	滯留；延遲；拘留
deter	威懾住，嚇住；使斷念[（+from）]
detergent	去垢的，使潔淨的 洗潔劑，洗衣粉；去垢劑[C][U]
devour	狼吞虎嚥地吃，吃光；吞沒，毀滅
diabetes	糖尿病
dictate	口授，口述，使聽寫；命令，規定，要求，指定[+wh-] 口授，口述；命令，支配
dictation	口述；聽寫[U]；口授（或聽寫）的文字[C]
dictator	獨裁者；【史】（古羅馬握有非常時期權力的）獨裁官
dictatorship	獨裁者的職位（或權力、任期）[U][C]；獨裁國家；獨裁政府[C]
diesel	柴油引擎；狄塞爾內燃機
differentiate	使有差異；構成......間的差別[（+from）]；區別，區分；鑑別[（+from）] 區別，區分；鑑別[（+between）]；區別對待[（+between）]
diplomacy	外交；外交手腕
directive	指導的；管理的；方向性的 指令
disable	使失去能力[（+from）]；使傷殘[H]
disastrous	災害的；災難性的，悲慘的
disbelief	不信；懷疑
discard	拋棄，丟棄[U]；被拋棄的東西（或人）[C]
discharge	排出（液體，氣體等）；允許......離開；釋放；解僱[H][（+from）] 排出液體（或氣體等）；（江河）流注[Q]；（船等）卸貨 排出，流出[U]；釋放；解僱[U]
disciple	信徒，門徒；追隨者；【宗】耶穌的信徒，使徒
disciplinary	訓練的；紀律的；懲戒的
disclosure	揭發；透露；公開[U]；揭發（或敗露）的事情[C]
discomfort	不舒服，不適；不安[U]；使人不舒服（或不安）的事物；困苦[C] 使不舒服；使不安
discreet	謹慎的，慎重的，考慮周到的；樸素的，不引人注意的
disgrace	丟臉，恥辱，不光彩；失寵[U]；丟臉的事；丟臉的人[S][（+to）] 使丟臉，使蒙受恥辱；使失寵；貶黜
dismay	驚慌，沮喪，氣餒[U] 使驚慌，使沮喪，使氣餒[H][（+at/by）]
dispensable	非必要的；可分配的；可寬恕的
dispense	分配，分發；施給[（+to）]；執行，施行；管理 免除；省掉[（+with）]
disposable	可任意處理的；可自由使用的；用完即丟棄的，一次性使用的
disposal	處理，處置；配置；布置；排列
dispose	配置，布置[（+for）]；處置，處理；整理 處置，處理；（能）決定[（+of）]
dissent	不同意，持異議；【英】不信奉國教 不同意，異議；（通常大寫）不信奉國教
distraction	分心，注意力分散[U]；困惑；焦躁不安[U]
distress	悲痛，苦惱，憂傷[U]；貧困，窮苦[U] 使悲痛，使苦惱，使憂傷[H][（+at/about）]；使貧困
disturbance	擾亂；打擾；騷擾，混亂；引起騷動的事物
diversify	使多樣化；把（資金）分投在幾家公司內 多樣化；從事多種經營
diversion	轉向，轉移；轉換[U][C]；分散注意力[U]
divert	使轉向；使改道[（+from/to）]；轉移；使分心[（+from）] 轉向；轉移
dividend	【數】被除數；【經】紅利；股息
doom	厄運，毀滅，死亡；【宗】末日審判，世界末日 注定，命定[H][（+to）][?]；判定，判決[（+to）]
dormitory/dorm	大寢室，團體寢室；【美】（學院等的）學生宿舍
downward	向下的，下降的[B]；日趨沒落的 向下；日趨沒落地
downward/downwards	向下的，下降的[B]；日趨沒落的 向下；日趨沒落地
doze	打瞌睡，打盹；半睡 在瞌睡中度過（時間）[（+away）] 瞌睡，假寐[S]
drastic	激烈的，猛烈的；嚴厲的；極端的
draught	【英】= draft
dresser	（劇場的）服裝員；（傷口）敷裹員；（櫥窗的）裝飾者；鞣革者；穿著講究者；穿......服裝的人
dressing	穿衣；服飾，衣服；打扮[U]；布置，裝飾[U]
dual	兩的，雙的；雙倍的；雙重的 雙數；雙數詞
dubious	（對事物）半信半疑的，猶豫不決的[（+of/about）]；曖昧的，含糊的
duration	（時間的）持續，持久；持續期間[U]
dusk	薄暮，黃昏；幽暗 【書】幽暗的；微黑的 【書】使變微暗；使變微黑 【書】變微暗；變微黑
dwarf	矮子；侏儒；矮小的動物（或植物） 矮小的；發育不全的；矮種的 使矮小；使顯得矮小 變矮小；萎縮；發育不全
dwell	居住，住；生活（在）；存在（於）[（+in）]
dwelling	住處，住宅，寓所[C]；dwell的動詞現在分詞、動名詞
eccentric	（人、行為等）古怪的，反常的；不同圓心的 古怪的人；偏心圓
eclipse	【天】蝕[C]；被遮蔽；（聲名、威望等的）黯然失色[C][U] 蝕，遮蔽（其他天體的光）；使失色
edible	可食的，食用的 食品；適合吃的東西[P]
editorial	編輯（上）的；編者的；主管的；社論的；社論式的 （報刊的）社論；（電臺，電視臺的）重要評論
electrician	電工；電氣技師[C]
elevate	舉起；抬起；使上升；提高（嗓子，道德品質，信心等）
emigrant	移居（他國）的；移民的 （往他國的）移民；移出者[C][（+to）]
emigrate	移居外國（或外地區）[（+from/to）] 使移居
emigration	移居；移民出境[U][C]；（總稱）移民[J]
encyclopedia	#NAME?
endeavor	努力，力圖[+to-v] 努力，盡力[C][U][+to-v]
endowment	（基金、財產等的）捐贈[U]；捐贈的基金、財產等[P1]
endurance	忍耐，耐久力；持久（力）；耐久（力）
enhance(ment)	提高，增加（價值，品質，吸引力等）
enlighten(ment)	啟發，啟迪；使擺脫矇昧；教育，教導
enrich(ment)	使富裕；使豐富
enroll(ment)	把......記入名冊，登記（名字等）；使入會；使入學，招（生）；使入伍，徵（兵）
equalize	使相等；使平等；使均等；使划一
equate	【數】用符號表示......的關係；等同
escort	護衛隊；護航隊；護航艦；護航飛機；儀隊[C][G]；護衛者，護送者[C] 護送；為......護航；陪同[（+to）]
esteem	尊重，尊敬；【古】評價；意見；價值 尊重，尊敬；珍重；認為，視為[（+as）][?][O8][O9][+that]
eternity	永遠，永恆；不朽[U]；（死後的）永世；來世[U]
evacuate	撤空，撤離；從......撤退；使避難，使疏散[（+from）]
evergreen	常綠的，常青的 常綠樹；萬年青[C]；裝飾用的常綠樹樹枝[P]
evoke	喚起（記憶等）；引起；召（魂）
examinee	應試者；受檢查者
examiner	主考人；檢查人；審查員[C]
excel	勝過，優於[（+in/at）] 突出；勝過他人[（+in/at）]
excerpt	摘錄；引用
excess	超越，超過[U][S1]；超額量[U][S1] 過量的；額外的；附加的[B]
exclusion	排斥，排除在外；被排除在外的事物
exempt	免除，豁免[（+from）] 被免除的；被豁免的[F][（+from）] 被免除（義務、責任）者；免稅者[C]
exert	用（力），盡（力）；運用，行使；發揮；施加
expenditure	消費；支出；用光[U][（+on）]；支出額；經費[U][C]
expiration	終結；期滿；吐氣
expire	滿期，屆期；（期限）終止；呼氣，吐氣 呼出（空氣）
extract	用力取出；使勁拔出，抽出；採掘；提取，提煉
extracurricular	課外的；業餘的；【口】婚外的
eyelash/lash	（一根）睫毛
eyelid	眼皮，眼瞼[C]
eyesight	視力，目力；視野，視界
fable	寓言[C]；虛構的故事；傳說；神話[C] 講寓言；編寓言；虛構；撒謊[（+about）] 煞有介事地講述
faction	（政黨，組織等內部的）派別，宗派；小集團[C]；派系之爭，內訌[U]
Fahrenheit	華氏溫度計的；華氏的 華氏溫度計；華氏溫標
falter	蹣跚，踉蹌；搖晃；（聲音）顫抖；結巴地說話 結巴地講出[（+out）] 動搖，猶豫；畏縮；顫抖；顫抖的聲音
familiarity	熟悉；通曉[U][（+with）]；親近；親暱，放肆[U]
fascination	魅力；有魅力的東西[U][S]；迷戀，陶醉[U]
feasible	可行的；可實行的[+to-v]；可能的；合理的
feeble	虛弱的，衰弱的；無力的；（智力，性格等）弱的，軟弱的
feminine	女性的，婦女的；嬌柔的，女孩子氣的；適合於女子的 女性；【文】陰性；陰性詞（或形式）
fertility	（土地的）肥沃；【生】繁殖力
fertilizer	肥料；促進發展者
fianc?/fiance	【法】未婚夫
fin	鰭；鰭狀物；（潛水用的或船的）鰭板；（飛機的）安定翼；（潛艇的）水平舵
finite	有限的；【數】有窮的 有限；有限之物
firecracker	爆竹，鞭炮[C]
fireproof	防火的；耐火的 使具防火（或耐火）性能；為......安裝防火設施
fishery	漁業，水產業[U]；漁場；養魚場[C]
flake	小薄片；扁薄的一層 成薄片；（成片）剝落[（+away/off）]；雪片似地降落 使成薄片；像雪花般覆蓋
flaw	裂隙；裂縫；缺點；瑕疵[（+in）] 使破裂；使有缺陷；使無效 生裂縫；變得有缺陷
flourish	（植物等）茂盛，繁茂；（事業等）繁榮，興旺 揮舞[（+at）]；炫耀，誇耀 揮舞；炫耀性的動作[C]；（手寫花體字上的）花飾[C]
flunk	使（某人）不及格；給（某人）打不及格分數；通不過（考試等） （在考試等中）失敗，不及格[（+in）]；（因畏縮而）撒手不做；放棄 失敗；不及格[C]
foe	敵人，仇敵；敵軍
folklore	民間傳說，民俗；民俗學[U]
formidable	可怕的，令人畏懼的；難以克服的，難對付的
formulate	使公式化；用公式表示；系統地闡述（或說明）
forsake	拋棄；遺棄；背棄；摒棄，革除
forthcoming	即將到來的[B]；現有的，隨時可得的[F]
fortify	築防禦工事於；築堡壘於；（在肉體，精神等方面）增強，加強 構築防禦工事；構築堡壘
fowl	禽[C]；家禽（雞，鴨，鵝等）[C] 打（或捕）野禽
fracture	破裂；斷裂；折斷；骨折[C][U][（+of）]；裂縫；裂面；裂痕[C] 使破裂；使斷裂；使折斷；使骨折；毀壞；打破；違反（規定等） 破裂；斷裂；折斷
fragrance	芬芳；香味；香氣[C][U]
fragrant	香的，芳香的
frantic	（因喜悅，憤怒等）發狂似的[（+with）]；狂暴的，狂亂的
freak	任性的舉動；怪誕的行動；畸形的人（或動植物） 反常的，怪異的，稀奇的[B]
freeway	【美】高速公路；高速幹道[C]
friction	摩擦；摩擦力[U]；不和，爭執[U][C]
fume	（有害，濃烈，或難聞的）煙，氣，汽[P]；憤怒；煩惱[S] 冒煙（或氣，汽）；（煙，汽等）冒出；發怒；怒氣衝衝地說話[（+at/over）] （用香）薰；煙薰；薰（木材等）；冒出（煙，汽等）
fury	狂怒，暴怒[U][C]；（天氣，疾病，感情等的）狂暴，猛烈[the S]
fuse	保險絲，熔線[C] 把保險絲接入（電路）；使（電器等）保險絲燒壞 （保險絲）熔斷；（電器等）因保險絲燒壞而中斷工作；熔化
fuss	忙亂；大驚小怪；小題大作[U][S1][（+about/over）]；異議；抱怨[S][（+about/over）] 忙亂；小題大作；大驚小怪[（+about/over）]；過分體貼關心[（+over）] 【口】使煩惱；煩憂
gallop	（馬等的）疾馳，飛跑[S]；騎馬奔馳[C] （馬等）疾馳，飛跑；匆匆地做（或讀，說等） 使（馬）疾馳，使飛跑
gangster	（結成團伙的）歹徒，匪盜，流氓[C]
garment	（一件）衣服[C]；服裝，衣著[P] 給......穿衣服[H]
gauge	標準尺寸，標準規格[U][C]；測量儀器；規，表，計[C] 量，測；估計，判斷
gay	【美】【俚】（一般指男子）同性戀的；鮮豔的；豔麗的；衣著華麗的 【美】【俚】同性戀者[C]
geographical	"地理學的,地理的"
geometry	幾何學[U]
glacier	冰河[C]
glamorous	富有魅力的；迷人的
glamour	魅力，誘惑力；迷人的美；妖豔 使著魔；迷住；迷惑；使有魅力；美化[（+up）]
gleam	微光；閃光[（+of）]；（情感等的）閃現，一絲[（+of）] 發微光；閃爍；閃現；突然露出
glide	滑動，滑行[Q]；滑翔；乘滑翔機飛行 使滑動，使滑行 滑動，滑行；滑翔，下滑
glitter	閃閃發光，閃爍；光彩奪目 閃光，閃耀[the S]；華麗，光彩[U]
gloom	黑暗；陰暗；昏暗[U]；【書】暗處；多陰的地方[C] 變陰暗，變陰沉；顯得悶悶不樂；感到沮喪[（+about/over）] 使暗；使陰沉；使憂鬱
goalkeeper	（足球等的）守門員
goodwill	善意，好心；友好，親善；樂意；自覺的努力
gorilla	大猩猩；（俚）暴徒，打手
gospel	（大寫）福音，基督教教義[U]；（大寫）福音書[the S] 福音的；傳播福音的；福音讚美詩的
grapefruit	葡萄柚（指植物或其果實）
graze	（牛，羊等）吃草；放牧 吃（田野）裡的草；在田野裡吃（草等）；用牧草餵；放牧 吃草；放牧；牧草
grease	動物脂；油脂；潤滑脂；羊毛所含的脂；未脫脂的羊毛 塗油脂於；用油脂潤滑；使油汙；【美】【俚】賄賂
groan	呻吟聲；哼聲；吱嘎聲 呻吟；發吱嘎聲 用呻吟表示；呻吟著說
growl	（狗等）嗥叫[（+at）]；（人）咆哮[（+at）] 咆哮著說[（+out）] 嗥叫（聲）；咆哮；轟鳴（聲）[C]
grumble	抱怨，發牢騷[（+at/about/over）]；咕噥；發哼聲；發轟隆聲 埋怨；對......表示不滿[（+out）] 怨言，牢騷[C]；轟隆聲[the S]
hacker	【電腦】熱心於使用電腦的人；【電腦】企圖不法侵入他人電腦系統的人
hail	向......歡呼；為......喝采；承認......為；擁立[（+as）] 招呼；招呼致意；（不用被動式）來自[（+from）] 歡呼；打招呼[C][U] （表示歡呼，祝賀等）好啊；歡迎
hamper	妨礙，阻礙；牽制；束縛 障礙物；束縛；【海】障礙船具
handicap	障礙，不利條件；（給強者不利條件或使弱者略佔優勢的）讓步賽 妨礙，使不利[H]；給（較強選手）設置不利條件
handicraft	手工藝，手藝[P1]；手工藝品[C]
harass(ment)	使煩惱，煩擾；不斷騷擾
harden	使變硬；使變堅固；使變得冷酷；使麻木 變硬；變堅固；變冷酷；變麻木
harmonica	口琴[C]
harness	馬具，挽具；挽具狀帶子；降落傘背帶；保險帶；安全帶 給......上挽具；套（馬）[（+to）]；治理，利用；控制，駕馭
haunt	（鬼魂等）常出沒於[H]；（思想，回憶等）縈繞在......心頭；使困擾[H] 常去的地方；（動物的）棲息地
headphone(s)	頭戴式耳機
healthful	有益於健康的；【喻】健康有益的
hearty	衷心的，熱誠的；健壯的，精力充沛的 （常用於水手）夥伴們，朋友們[P]
hedge	樹籬；籬笆；障礙（物）；界限 用樹籬笆圍住（或隔開）；圍住；設障礙於 修築樹籬；避免直接答覆
heighten	加高，增高；增加；提高 變高，升高；變強，變濃
hemisphere	（地球的）半球；半球體；半球上的國家（或居民）
heroic	英雄的，英勇的；記敘英雄及其事跡的，史詩的
heroin	海洛因
heterosexual	異性的 異性戀的人
hierarchy	等級制度；僧侶統治（集團）
hijack	劫持; 攔路搶劫
hoarse	（嗓音）嘶啞的；粗啞的；嗓音嘶啞的；嗓子粗啞的
homosexual	同性戀的 同性戀者
honorary	（學位等）名譽上的；（官職等）名譽職位的
hospitable	好客的，招待周到的；（氣候、環境等）宜人的；適宜的
hospitality	好客；殷勤招待；（對新思想等的）接受能力，理解力
hospitalize	使住院治療
hostel	旅舍（尤其指青年旅舍）
hover	（鳥等）盤旋；（直升機）停留在空中；徘徊；停留 盤旋；徘徊，猶豫[U]
humiliate	使蒙恥辱；羞辱；使丟臉
hunch	預感，直覺[+that]；隆肉；瘤；肉峰；厚片，大塊 使（背部）隆起，使成弓狀[（+up）] 向前移動；推進；隆起，彎成弓狀
hurdle	（賽馬或賽跑用的）欄；跳欄[C]；跨欄賽跑[P][J] 跨（欄）；克服（困難）
hybrid	（動植物的）雜種；混血兒；混合源物；合成物；混合詞 雜種的；混合而成的
hygiene	衛生；衛生學；保健法[U]
hypocrite	偽善者，偽君子[C]
iceberg	冰山；浮在海洋上的巨大冰塊；冷峻的人
illuminate	照亮；照射；用燈裝飾（房屋等）[（+with）] 照亮；用燈裝飾
imminent	（危險等）逼近的；即將發生的
imperative	必要的；緊急的；極重要的；命令式的；必須服從的；專橫的 必須履行的責任；必要的事；需要[C]；命令；規則[C]
imperial	帝國的；（常大寫）大英帝國的；皇帝（或女皇）的；最高（權力）的 （蓄於下脣下的小綹鬍鬚）皇帝髯[C]
implicit	不言明的；含蓄的；內含的；固有的[（+in）]
imposing	壯觀的；氣勢宏偉的；莊嚴的；給人深刻印象的；impose的動詞現在分詞、動名詞
imprison(ment)	監禁；關押；限制，束縛，禁錮
incline	傾斜；屈身；彎腰；點頭；心裡傾向，有意[Q][（+to/towards）][（+to-v）] 使傾斜；屈（身）；彎（腰）；低（頭）；使傾向於，使想要[H][?][O]
inclusive	包含的，包括的[（+of）]；包括一切費用在內的
incur	招致，惹起，帶來；遭受
indifference	漠不關心；冷淡；不感興趣[（+to/towards）]；不重要，無關緊要[（+to）]
indignant	憤怒的；憤慨的[（+at/about/over/with）]
induce	引誘；勸[?]；引起；導致
industrialize	使工業化 實現工業化
infectious	傳染的；傳染性的；有感染力的，易傳播的
infer	推斷，推論；猜想[（+from）][+（that）]；意味著；暗示；表明 作出推論
inflict	給予（打擊）；使遭受（損傷等）；強加；加以（處罰或判刑）
inhabit	居住於；棲息於；存在於；佔據
inhabitant	（某地區的）居民，居住者；（某地區、部位等）棲居的動物
injustice	非正義；不公正，不公平[U]；非正義（或不公正）的行為[C]
inland	內地的，內陸的；【英】國內的 內地，內陸[U] 在內地，在內陸；向內地，向內陸
innumerable	無數的；數不清的
inquire	訊問；查問；調查[+wh-] 詢問；調查[（+about/into）]
insistence	堅持；強調；竭力主張；堅決要求[U][（+on/upon）][+that]
instinctive	（出於）本能的；（出於）天性的；（來自）直覺的
intake	引入口；通風口；(水/空氣等的)入口；吸收；攝取
intellect	智力；理解力；思維能力[U][C]；非凡的才智，出眾的才華[U]
interpreter	口譯員，通譯員；解釋者
intersection	橫斷，交叉[U]；交叉點；道路交叉口；十字路口[C]
intervene	插進；介入；介於中間[（+between）]；干涉，干預；調停[（+in/between）]
intimacy	熟悉；親密；親近[U][S1][（+with）]；親昵的言語（或行為）[C][P1]
intimidate	威嚇；脅迫
intonation	語調；聲調[U][C]；抑揚之聲；吟誦[U]
intrigue	陰謀策劃[U]；陰謀，詭計；密謀[C] 耍陰謀，施詭計[（+with/against）]；私通[（+with）] 耍陰謀強使，施詭計取得；激起......的好奇心（或興趣）
intrude	侵入；闖入；侵擾，打擾 把......強加（在）[（+on/upon）]；把......硬擠（入）[（+into）]
intruder	侵入者；闖入者；干擾者[C]
invaluable	非常貴重的，無價的；無法估價的[（+for/to）]
invariably	不變地，一定地，總是
inventory	存貨清單；存貨盤存（報表）；財產目錄[C][U]；清單上開列的貨品；存貨[C][U] 編制（詳細目錄等）；把......登入目錄；盤存
ironic	冷嘲的，挖苦的；具有諷刺意味的；出乎意料的
irritable	易怒的，急躁的；煩躁的；【醫】過敏的
irritate	使惱怒；使煩躁；使過敏；使難受；使發炎；使疼痛 引起惱怒；引起不愉快
isle	島，小島[C]
itch	癢[S]；【醫】疥瘡[the S] 發癢；渴望，熱望[（+for）][+to-V] 使發癢；使煩惱；使惱怒
ivy	【植】常春藤[U]；類似常春藤的植物[C] 【美】（通常大寫）常春藤聯盟的；常春藤聯盟大學派頭的
jade	瘦馬；駑馬；【古】【貶】蕩婦；輕佻的姑娘 使疲倦不堪；使厭倦 變得疲倦不堪；厭倦
janitor	門警，看門人；（公寓、學校等處的）照管房屋的工友
jasmine	茉莉；茉莉花茶
jingle	（鈴、硬幣等金屬的）叮噹聲；音韻鏗鏘的詩 發出叮噹聲；作音韻鏗鏘的詩；重複同一韻（或聲音） 使發出叮噹聲
jockey	賽馬的騎師，騎士；【美】【俚】駕駛員；（機器等的）操作者 （在賽馬中）騎（馬）；欺騙；耍手段使[（+into/out of）] 充當賽馬騎師；耍手段圖謀[（+for）]
jolly	快活的，高興的；【口】令人愉快的，宜人的 【英】【口】非常，很 【口】用好話勸（某人）做......[（+into/out of）]；【口】用好話使高興[（+along）] 【口】開玩笑
joyous	快樂的；高興的
junction	連接，接合，匯合[C][U]；接合點；交叉點；（鐵路的）聯軌站；（河流的）匯合處[C]
kin	家族；親戚；同類[K][（+to）] 有親屬關係的；同類的；類似的[（+to）]
kindle	點燃；燃起；激起（熱情等）；煽動 著火，燃起；（人，感情等）激動起來
knowledgeable	有知識的，博學的；有見識的[（+on/about）]
lad	男孩，少年；青年男子，小伙子；【口】（表示親密的稱呼）傢伙，伙伴，老弟
landlady	女房東；（旅館，家庭公寓等的）女主人，女老板；女地主
landslide	山崩；滑坡；（選舉中的）壓倒性大勝利
latitude	緯度[U]；緯度地區[P]
lavish	非常慷慨的；浪費的，濫花的[（+of/with）]；極其豐富的；大量的；無節制的 揮霍，浪費；濫施[（+on）]
layman	（未受神職的）一般信徒；俗人；外行人，門外漢
layout	安排；設計；布局[C]；（書籍、廣告等的）版面設計，版面編排[C][U]
lease	租約，租契；租賃；租賃權 出租（土地等）[（+out）]；租得（土地等）[（+from）]；長期租用 出租
legislator	立法者，立法委員；國會議員[C]
lengthy	長的；冗長的；囉唆的
lesbian	女同性戀者 （女性間的）同性戀的
lessen	變小，變少；減輕 使變小，使變少；使減輕；【古】藐視；貶低
lethal	致命的；危險的；毀滅性的
liable	易患......的；易......的[（+to）][+to-v]；會......的；【美】【口】可能的[+to-v]
liberate	解放，使獲自由[（+from）]；【化】釋放
liberation	解放[（+from）]；解放運動
lieutenant	（美國）陸軍（或空軍，海軍陸戰隊）中尉，少尉；（英國）陸軍（或海軍陸戰隊）中尉；海軍上尉
lifelong	終身的，一輩子的[B]
lighten	變亮；發亮；打閃電 使光明，照亮；使變淡
limp	一瘸一拐地走，跛行；緩慢費力地前進 跛行[S]
liner	班輪；班機；畫線的人；畫線工具
linger	繼續逗留，徘徊[（+on）]；持續，緩慢消失[（+on）] 消磨，緩慢度過[（+away/out）]
lining	襯裡，內襯，內層[C]；襯裡布[U]；加襯，砌襯[U]
liter	（公制容量單位）公升
literacy	識字；讀寫能力；知識；能力
literal	照字面的；原義的；如實的，不誇張的
literate	能讀寫的；有文化修養的 能讀寫的人；有文化修養的人
livestock	（總稱）家畜
lizard	【動】蜥蜴；類蜥蜴爬行動物[C]
locker	（體育館等公共場所供個人用的）衣物櫃；【美】（冷藏貨棧出租的）冷藏格
lodge	（工廠，學校等的）守衛室；（公園等的）看守人的小屋；（會社等的）地方支部，集會所 供給......臨時宿處；租房間給......住；將......射入；刺進；打在[O][（+in）] 暫住，投宿，寄宿[Q]；停留；嵌入；卡住[Q][（+in）]
lofty	高聳的，極高的；崇高的，高尚的
logo	標識
lonesome	寂寞的；孤單的；人跡稀少的，荒涼的 【口】自己，本人[U]
longevity	長命，長壽；壽命
longitude	經度[U][C]
lotion	（化妝等用的）化妝水，塗劑，護膚液；外用藥水；洗滌劑
lottery	彩券，獎券，彩票；摸彩，抽籤[C]；運氣，難算計的事[S]
lotus	蓮花
loudspeaker	揚聲器，擴聲器，喇叭[C]
lucrative	賺錢的，有利可圖的
lullaby	催眠曲，搖籃曲[C] 唱搖籃曲使入睡；（以溫和的聲音）使安靜
lunar	月的；月球上的；按月球的運轉測定的；陰曆的
lure	誘惑物[C]；誘惑力，吸引力；魅力[the S][（+of）] 引誘，誘惑；以誘餌吸引[O]
lush	蒼翠繁茂的；多汁的；豐富的 酒；酒鬼；醉漢 【俚】喝酒 喝（酒）；向......灌酒
madam/ma'am	（對婦女的恭敬稱呼）夫人，太太，小姐；（大寫）（正式書信中對婦女的尊稱）女士
magnify	放大，擴大；誇張，誇大 放大，擴大；有放大能力
maiden	少女，處女；（賽馬中）未得過獎的馬 未婚的，少女的，處女的；初次的，新的
mainland	大陸，本土[the S] 大陸的，本土的[B]
majestic	雄偉的；威嚴的；崇高的
majesty	雄偉，壯麗；莊嚴[U]；（帝王的）威嚴；尊嚴[U]
manuscript	手寫的；原稿的 手寫本，手稿；打字稿；原稿[C]
maple	槭樹，楓樹[C]；槭樹木材，槭木[U]
mar	毀損；損傷；玷汙 汙點；缺點[C]
marginal	頁邊的，欄外的[B][Z]；邊緣的；邊境的
martial	戰爭的；軍事的；軍隊的；好戰的；尚武的
marvel	令人驚奇的事物（或人物）[（+of）] 對......感到驚異[Y][+that][+wh-] 感到驚訝；感到好奇[（+at）]
mastery	支配，統治；優勢，優勝
mediate	調停解決；傳達 調解；斡旋；居中 間接的；居間的
medieval	中世紀的；中古風的；老式的；守舊的
meditate	沉思，深思熟慮[（+on/upon）] 計畫；打算；企圖[+v-ing]；【罕】思考；研究
meditation	沉思，默想；冥想[U][P1]；【宗】默念，默想[U][P1]
melancholy	憂鬱；憂思，愁思 憂鬱的，鬱悶的；令人沮喪的；可悲的
mentality	智力，精神性[U]；心理狀態，心性[C][U]
merchandise	商品，貨物[U] 買賣，經營；促進......的銷售，推銷 經商
mermaid	美人魚；【美】女子游泳健將
migrant	移居（尤指移出國境）的；流浪的 移民；移居者；候鳥
mimic	（透過學樣）戲弄；模仿，學......的樣子；照樣子畫 善於模仿的人；能模仿人的動物；滑稽劇演員，小丑 模仿的；好模仿的；模擬的；非真的，假裝的
mingle	使混合，使相混[（+with/together）] 混合起來，相混合；交往，往來[（+with/in）]
miraculous	神奇的；超自然的；奇蹟般的；驚人的
miscellaneous	混雜的，五花八門的；各種各樣的；多才多藝的
mischievous	惡作劇的；調皮的，淘氣的；有害的；惡意傷人的
mistress	女主人，主婦；女名家，女能手
mobilize	動員；調動；使流通；使鬆動 動員起來
modernization	現代化；現代化的事物[U][C]
modernize	使現代化 現代化
momentum	【物】動量，衝量[U][C]；氣勢，衝力[U]
monarch	君主；最高統治者
monetary	金融的；財政的；貨幣的；幣制的
monotony	（聲音等的）單調；無變化，千篇一律[U]
monstrous	怪異的；似怪物的；醜陋的；可怕的，毛骨悚然的 【古】【方】非常，很
moody	心情不穩的，喜怒無常的；悶悶不樂的，鬱鬱寡歡的
morale	士氣，鬥志；道德；品行
mortal	會死的；死的；臨死的；人的，凡人的[B] 人，凡人[C][P1]
motherhood	母性；母親的身分
motto	座右銘；格言；訓言；（書籍扉頁上或章節前引用的）警句；題詞
mound	土墩；土石堆；土堤；墳堆，塚 【古】築牆防衛；堆起 積成堆
mourn	哀痛，哀悼[（+for/over）]；服喪 為......哀痛；向......誌哀；悲哀地說
mournful	憂傷的；悲切的；淒慘的；悲觀的，意氣消沉的
mow	（用鐮刀等）刈（草等）；刈（草坪等）上的草 刈草（或麥等）
muse	沉思，冥想[（+about/on/upon/over）] 若有所思地說；沉思 【古】沉思，冥想[S]
mustache	髭，小鬍子；鬚狀物；（哺乳動物的）觸鬚
mute	沉默的；一時說不出話的；不用言語表達的；啞的，不會說話的 啞巴；【語】閉鎖音 消除（聲音），減輕（聲音）；使（顏色等）柔和
nag	使煩惱；跟......糾纏不休；不斷地找......的岔子[（+for/into）][OZ]；（問題等）困擾[（+into）][（+at）] 不斷嘮叨；責罵不休；（痛楚等）不斷引起苦惱 【口】好嘮叨的人（尤指女性）[C]
narrate	講（故事）；敘述；給（電影等）作旁白 講述，敘述；（給電影等）作旁白
narrator	解說員；敘述者，講述者
nationalism	民族主義；國家主義；民族獨立運動
navigate	航行於；飛行於；駕駛；操縱；導航；引導 航行，航空；駕駛船舶（或飛機等）；導航
navigation	航海；航空；航行；航海術；航行學；領航，導航
nearsighted	近視的；近視眼的；目光短淺的，短視的
nickel	【化】鎳[U]；【美】五分鎳幣[C] 鍍鎳於
nostril	鼻孔[C]
notable	值得注意的，顯著的[（+of）]；著名的，顯要的[（+for）] 名人；顯要人物[C][P1]
notorious	惡名昭彰的，聲名狼藉的[（+for）]
nourish(ment)	養育；滋養；施肥於
novice	新手，初學者[（+at）]；【宗】見習修士（或修女）
nucleus	【核】（原子）核；【生】細胞核
nude	裸的；與生俱有的；無裝飾的；無毛的 裸體畫像；裸體者；裸體
nurture	營養物，食物；養育，教養，培育 養育，培育，教養；給......營養，培植
oasis	（沙漠中的）綠洲；【喻】（困境中的）令人寬慰的事物或處所
oath	誓言，誓約；宣誓[+（that）]；詛咒；詛咒語
oatmeal	燕麥粉，燕麥片；燕麥粥
oblige	使不得不，迫使[H][?]；施恩於；答應......的請求 施恩惠，幫忙
obsess	迷住，使著迷；纏住；使窘困，使煩擾
obstinate	頑固的，固執的；頑強的，不屈服的
occurrence	發生；出現[U]；事件；事變[C]
octopus	章魚；像章魚般觸角伸向四處的事物
odor	氣味；香氣；臭氣[C]；意味[C]
offshore	近岸的；近海的；離岸的；向海的 離岸；向海面
offspring	子女；子孫；後代；（動物的）幼獸；（植物的）幼苗
operative	操作的；運行著的；從事生產勞動的 技工，工人；偵探，間諜
oppress	壓迫；壓制；使（心情）沉重；使煩惱，折磨[H][（+by/with）]
oppression	壓迫，壓制[U][C]；壓抑；沉悶[U]
ordeal	嚴峻考驗；苦難，折磨[C][S1]；神裁法（古條頓族施行的判罪法，如將嫌疑犯的手浸入沸水中，受神主宰，手無損，則無罪）[U]
orderly	整齊的；有條理的；愛整潔的 （醫院的）勤務員，護理員；勤務兵；傳令兵 按順序地，挨次地；整齊地，有條理地
organizer	組織者；（工會等的）組織幹部
orient	【文】東方[the S]；（大寫）亞洲；東方（國家）[the S] 【文】東方的；【文】（太陽）正在升起的
oriental	（大寫）東方的；亞洲的；東方人的；東方文化的；東的，東部的 （大寫）東方人，亞洲人[C]
originate	發源；來自；產生[Q][（+in/from/with）] 引起；創始；發明；創作
ornament	裝飾品[C]；裝飾，修飾[U] 裝飾；美化[（+with）]
orphanage	孤兒院；孤兒身分；（總稱）孤兒
orthodox	正統的；傳統的，習俗的；通常的；（大寫）【宗】東正教（會）的[Z]
ounce	盎司，英兩（常衡= 1/16磅；金衡及藥衡= 1/12磅）[C]；流量啢，液盎司（= 1/16品脫）[C]
outbreak	爆發[（+of）]；暴動
outgoing	外出的；出發的；即將離職的 出發；出外；（常複數）開支；費用
outing	遠足；郊遊；短途旅遊；體育比賽；劃船練習；跑馬練習
outlaw	歹徒，罪犯，亡命之徒；被剝奪法律保護者；被放逐者 宣布......為不合法；剝奪......的法律保護；使在法律上失效；禁止，限制
outlook	觀點，看法[（+on）]；展望，前景[（+for）] 比......好看；用目光壓倒（對方） 朝外看
outnumber	數量上超過
outrage	惡行，暴行[C][（+on/upon）]；嚴重的不道德行為；不法行為[C][（+against/on/upon）] 激起......的義憤，激怒；對......施暴行
outrageous	可憎的；可恥的；粗暴的；無法無天的
outright	全部地；徹底地；無保留地；公然 全部的；徹底的；無保留的；直率的；公開的
outset	最初，開始，開端[the S]
outskirts	（複數）郊外；郊區；outskirt的名詞複數
outward	向外的；往外去的；外面的 向外；出海，出港；顯而易見地 外面；外表
outward/outwards	向外；出海，出港；顯而易見地
overdo	把......做得過分；使過於疲勞 做得過分；表演過火
overflow	泛濫；滿（或多）得溢出；充滿；洋溢[（+with）] 使漲滿；從......中溢出；淹沒；多得使無法容納；擠出[（+into/onto）]
overhear	偶然聽到，無意中聽到；偷聽[?][?] 無意中聽到；偷聽到
overlap	與......部分重疊；與......部分同時發生；與......部分相同 部分重疊；部分同時發生；部分相同
overwork	使工作過度，使過分勞累；過度使用；把......做過頭 工作過度
oyster	【動】牡蠣；蠔；【口】沉默寡言的人；嘴緊的人
ozone	臭氧；【口】新鮮的空氣
packet	小包（裹）；小捆；小袋[C][（+of）]；郵船；定期船[C] 把......打成小包，把......包起來
paddle	（短而闊的）槳；槳狀物；（攪拌混合用的）攪棒；（桌球的）球拍 用槳划（船）；划船運送 划槳行進；蕩槳；用槳輪推進行船
paperback	平裝本[C] （書）紙面裝訂的，平裝（本）的
paradox	似非而可能正確的議論[C][U]；自相矛盾的議論[C][U]
paralyze	使麻痺；使癱瘓；使全面停頓；使無力，使不能活動；使氣餒；使驚呆
parliament	議會，國會；（大寫）（英國，加拿大等的）國會
pastime	消遣；娛樂[C]
patriot	愛國者[C]
patriotic	愛國的
peacock	雄孔雀；孔雀；愛炫耀的人，愛虛榮的人 炫耀；（孔雀般）神氣活現地走
pebble	小卵石[C]；水晶[U] 用卵石鋪（走道等）；用卵石連續扔
peek	偷看，窺視[（+at/in/out）] 偷偷一看；一瞥
pending	懸而未決的；未定的；待定的；迫近的 在......期間；直到......時為止
peninsula	半島[C]
perch	（鳥類的）棲息處，棲木；（位置較高的）休息處；高處 （鳥）飛落，棲息；（在較高處）暫歇 使飛落，使暫棲[O][（+on）]；把......置於（較高或較險處）[O][（+on）]
peril	（嚴重的）危險[U]；危險的事物[C] 使有危險，使臨險境；危及
perish	消滅；死去；暴卒；枯萎；腐爛 毀壞；使死去；使困頓；使麻木
permissible	可允許的
persevere	堅持不懈；不屈不撓[（+at/in/with）]；（在辯論中）固執己見
persistence	堅持；固執；持續；持久
persistent	堅持不懈的；固執的；持續的，持久的
petrol	汽油
petroleum	石油[U]
pharmacist	製藥者；藥劑師；藥商
pharmacy	藥局，藥房，藥店，藥品部；配藥學
pianist	鋼琴家；鋼琴演奏者[C]
pickpocket	扒手[C]
pilgrim	香客，朝聖者；（在國外的）旅行者；浪人
pimple	丘疹；面皰；疙瘩；粉刺；青春痘
pinch	捏，擰；夾痛，軋痛；掐掉（嫩枝等）；修剪[（+out/off/back）] 夾痛；擠痛；（向裡）擠壓，收縮[（+in）] 捏，擰；夾[C]；夾痛，擠痛[the S]
plague	瘟疫[C]；鼠疫[the S] 使染瘟疫；使受災禍
plantation	農園，大農場；造林地；人造林
playwright	劇作家[C]
plow	犁[C]；似犁的工具；除雪機，剷雪機[C] 犁，耕；用犁掘（畦），挖（溝，槽） 犁地，耕地；可犁，可耕
pneumonia	【醫】肺炎[U]
polar	北極的，南極的；極地的；極的；極性的；磁極的；電極的
ponder	仔細考慮；衡量[+v-ing][wh-]；反思，回想 沉思，默想；仔細考慮[（+on/upon/over）]
pony	矮種馬；小馬；小型的東西 【美】【俚】付清[（+up）]；【美】【俚】借助直譯文閱讀 【美】【俚】付清[（+up）]；【美】【俚】借助直譯文閱讀
populate	居住於[H]；移民於；殖民於
porter	（車站，機場等的）搬運工人，腳夫；【美】（臥餐車，特等車的）服務員
posture	姿勢，姿態[C][U]；情形，態勢[the S] 使擺出特定姿勢 擺出姿勢；裝模作樣，故作姿態
potent	強有力的；有權勢的；有影響的；（藥等）有效力的，有效能的
poultry	家禽[U][G]；家禽肉[U]
preach	【宗】布道；講（道）[+that]；鼓吹；反覆灌輸 講道；說教[（+to/about）]；鼓吹，宣揚 講道；說教；訓誡
precede	（順序，位置或時間上）處在......之前；（地位等）高於，優於 處在前面；領先
precedent	先例，前例；【律】判例[C]；慣例[U] 在前的，在先的，前面的[（+to）]
precision	精確（性）；精密（度）；準確（性）；確切（性）；清晰（性）；明確（性） 精確的；精密的
predecessor	前任；前輩；（被取代的）原有事物
prehistoric	有文字記載的歷史以前的，史前的；【口】非常古老的；完全過時的，舊式的
premiere	初次上演 初次上演；（戲劇的）女主角 初次的；首位的；女主角的
preside	擔任會議主席，主持[（+at/over）]；管轄；指揮[（+over）]
prestige	名望，聲望，威望[U]
preventive	預防的，防止的；防病的[Z] 預防法，預防措施；預防物；預防藥[C]
preview	預看；預先審查（或檢查）；預習；（戲劇等的）試演；（影片等的）試映；（展覽會等的）預展 預看；預先審查（或檢查）；預習；試演；試映；預展
priceless	貴重的，無價的；稀世之珍的；【口】極為有趣的；極為荒唐的
privatize	使私有（民營）化
probe	【醫】探針，探子；（對傷處等的）針探，探查 用探針（或探測器）探查，探測；刺探；徹底調查 用探針（或探測器）探查，探測[（+for）]；查究；調查[（+for/into）]
procession	一（長）列，一（長）排[C][（+of）]；（人或車輛等的）行列，隊伍[C] 列隊行進 沿著（街道）行進
proficiency	精通；熟練
prohibition	禁止；被禁[U][C][（+of/against）]；禁令[C][（+of/against）]
propel	推進，推；推動；驅策，激勵
prose	散文；散文體[U][S1]；平凡；單調；無聊[U] 寫散文；乏味地講話（或寫作）[（+about）] 把（詩等）改寫成散文 散文的；用散文寫的；平凡的；乏味的；無想像力的
prosecute	對......起訴；告發；依法進行[（+for）]；徹底進行；執行 起訴；告發[（+for）]；作檢察官
prospective	預期的，盼望中的；未來的；即將發生的[Z][B]
prototype	原型；標準；模範
proverb	諺語，俗語，常言[C]；眾所周知的人（或事）[C]
provincial	省的[Z][B]；外省的，外地的[Z][B] 地方居民；外省人；鄉下人；興趣（或眼界）狹窄的人；粗野的人
provisional	臨時的，暫時性的，暫定的 【美】（正式郵票發行前的）臨時郵票[C]
psychiatry	精神病治療；精神病學
psychic	精神的；心靈的；超自然的 靈媒，巫師
psychotherapy	精神療法；心理療法
publicize	宣傳；公布；廣告
puff	一陣陣地吹（或噴）；噴著煙移動[Q][（+away/out）] 一陣陣地吹（或噴）（空氣，塵土等）；噴著煙行（路） （一）吹，（一）噴[C]；一陣，一股[C][（+of）]
punctual	嚴守時刻的；準時的[（+for/in）]；（表達方式等）正確的；精確的
purify	使純淨，淨化；使純粹；提純，精鍊 變純淨；變純潔；變純粹
purity	純淨，清潔；純潔，清白；貞潔
quake	顫抖，哆嗦[（+at/with/for）]；震動；搖晃 顫抖，哆嗦；地震；震動，搖晃
qualification	賦予（或取得）資格[U]；資格，能力[P][（+for）][+to-v]
radiant	光芒四射的；明亮照耀的[B]；容光煥發的；（面容，目光）洋溢著幸福的[（+with）] 發光（或發熱）的物體，光點；（電爐等的）白熾部分
radiate	（光、熱等）散發，輻射；（感情等）流露，顯出 發射（光、熱等）；散發，傳播 有射線的；具輻射部的；輻射狀的；【植】【動】輻射狀的；輻射對稱的
radioactive	放射性的
radish	蘿蔔；小蘿蔔[C]
radius	半徑；半徑距離；半徑範圍[C][the S][（+of）]；周圍，範圍[the S][（+of）]
rap	叩擊（聲）；敲擊（聲）；拍擊（聲）[（+on/at）]；饒舌音樂，饒舌歌曲 叩擊；敲擊；拍擊；厲聲地說[（+out）] 敲擊；拍擊[（+on/at）]
rash	草率從事的，輕率的；急躁的，魯莽的
ratify	（正式）批准；認可
realization	領悟；認識；真實；現實；體現
reap	收割（莊稼）；收割（田地）裡的莊稼；收穫；獲得，得到 收割；收穫；遭到報應；得到報償
reckless	不注意的，不在乎的；魯莽的，不顧後果的[（+of）]
reckon	計算，數；測算，測量 計算，數；估計；判斷
reconcile	使和解，使和好[（+with）]；調停，調解
recreational	消遣的；娛樂的；休養的
redundancy	過多，多餘，冗餘，重複[U]；多餘物，多餘量；冗語，贅詞[C]
reef	【海】縮帆部，疊帆部[C] 縮（帆），疊捲（帆）；縮（桅）；收進（舟首斜桁等）
referee	（籃球、足球、拳擊等的）裁判，裁判員；仲裁人，調停人 為......擔任裁判；仲裁，調停；審閱，鑑定 擔任裁判；仲裁，調停；審閱，鑑定
referendum	公民投票；（外交使節致本國政府的）請示書
refine(ment)	提煉，精鍊；精製；提去（雜質等）[（+out/away）]
reflective	反射的；反照的；思考的，沉思的
refresh(ment)	使清新，使清涼；消除......疲勞，使重新提起精神 吃點心，喝飲料；恢復精神，重新振作
refreshment(s)	精力恢復；心曠神怡[U]；起提神作用的東西（如食物、休息等）[C][U]
refute	駁斥，反駁，駁倒
rehabilitate	（使）復興；（使）恢復原狀；（使）復權；（使）復職
rehearse	排練，排演；給......排練 排練，排演；練習；演習
reign	統治；支配[U]；在位期間，統治時期[C] 君臨；統治[（+over）]；支配；盛行，佔優勢
rejoice	欣喜，高興[（+at/over）][+to-v][+that]；慶祝，歡樂 使高興，使欣喜
relay	接替；接替人員；替換的馬（或獵狗等）[C]；接力賽跑；接力賽中的一程[C] 分程傳遞；轉達；轉播；給......換班；使得到替換（或補充） 分程傳遞；轉達；轉播
relentless	殘酷的，無情的；不間斷的，持續的；堅韌的，不懈的
reliance	信賴，信任；信心[U][（+on/upon/in）]；依賴，依靠[U][（+on/upon）]
reliant	依賴的；依靠的；有信心的
relic	遺物；遺風，遺俗[C][（+of）]；紀念物[C][（+of）]
remainder	剩餘物；其餘的人[the S][G]；【數】差數；餘數，餘項[C][the S] 剩餘的；吃剩的 削價出售（剩書等）[H]
reminiscent	回憶往事的；懷舊的；好回憶往事的，喜愛懷舊的
renowned	有名的；有聲譽的
reproduce	繁殖，生殖；複製；翻拍；複寫；再上演 繁殖，生殖；被複製
reptile	爬行動物；爬蟲類；可鄙的人，卑鄙屈節的小人 爬行動物（似）的；爬行的；卑下的，卑躬屈節的
resent(ment)	憤慨；怨恨[+v-ing]；
reside	住，居住；駐在[Q]；（權力，權利等）屬於，歸於[（+in）]
resistant	抵抗的；抗......的；防......的 抵抗者；防染劑
respective	分別的；各自的[B]
restoration	恢復；復位；復辟；修復；復原；整修；重建
restrain	抑制，遏制；控制，限制；約束，阻止[（+from）]
restraint	抑制；克制[U][C]；控制；阻止；禁運[U][C]
retort	反擊；就......進行報復；反駁，回嘴說[+that] 反擊；報復；反駁，回嘴[（+on/upon）] 反擊；回嘴；反駁[C][U]
retrieve	重新得到，收回；（獵犬）銜回（被擊中的獵物） （獵犬等）銜回獵物 復得，收回，取回；恢復；【電腦】檢索
revelation	揭示；暴露；顯示[U][C]；被揭露的真相[C][+（that）]
revival	甦醒；復活；再生[C][U]；復興，再流行[C][U]
revive	甦醒；復甦；恢復精力，復元；恢復生機 使甦醒；使復甦；使恢復精力，使復元；使恢復生機
revolt	反叛；起義；造反[（+against）]；厭惡，反感[（+at/from/against）] 使厭惡，使反感，使噁心 反叛，起義，造反[C][U][（+against）]；厭惡，反感，噁心[U][S]
revolve	旋轉，自轉[（+on）]；沿軌道轉[（+round/about）] 使旋轉；反覆思考，斟酌
rigorous	嚴格的；嚴厲的；苛刻的；嚴酷的；嚴峻的
ripple	漣漪，細浪；波紋[C]；（頭髮的）波浪式；（衣裙的）褶子[C] 輕輕蕩漾；起漣漪；（頭髮等）呈波狀 使起漣漪；使呈波狀；使發出潺潺聲
rivalry	競爭；對抗[U][（+with）]；競爭行為；對抗行為[P1]
roam	漫步；漫遊；流浪[Q][（+about/through/around）] 在......漫步；漫遊；在......流浪 漫步；漫遊；流浪[S]
robust	強健的；茁壯的；健全的；結實的，堅固耐用的
rotate	旋轉，轉動[（+around）]；循環，輪流 使旋轉，使轉動；使輪流；輪換 【植】輻狀的
rotation	旋轉；【天】自轉；循環；輪流，交替；（農作物的）輪作
royalty	（總稱）皇族或王族（成員）[U][G]；王位；王權；王威[U]
rubbish	垃圾；廢物；廢話；無聊的想法 抨擊；貶低
rugged	高低不平的；粗糙的；粗線條的；多皺紋的；粗壯的，強健的；能吃苦耐勞的
ruthless	無情的，殘忍的；硬著心腸下定決心的，堅決的
salute	向......行禮，向......致敬；（以正式禮儀）祝賀；向......致意；迎接 行禮，致敬；致意，打招呼 敬禮[C]；敬禮姿勢[the S]；致敬；致意[C][U]
salvage	海難救助；搶救；挽救；救助酬金 救助；營救；搶救；挽救[（+from）]；打撈
sanitation	公共衛生，環境衛生；衛生設備，盥洗設備；下水道設施
savage	野性的；兇猛的；殘酷的；猛烈的；未開化的，野蠻的，原始的 野蠻人，未開化的；殘暴成性的人 （狗等）亂咬；兇猛地攻擊；激烈抨擊；粗暴地對待
scenic	風景的；景色秀麗的；描繪實景的[Z]
scorn	輕蔑；藐視[U][（+for）]；嘲笑；奚落[U] 輕蔑；藐視；拒絕；不屑做[+to-v][+v-ing] 表示輕蔑，表示鄙視
scrape	刮，擦；括（或擦）乾淨；刮落，擦去，削掉[O][（+off/away/out）] 刮，擦[（+on/against）]；刮（或擦）出刺耳聲[（+on/against）] 刮，擦；挖；擦傷；擦痕
screwdriver	螺絲起子；螺絲刀
scroll	卷軸；裱成卷軸的古書；畫卷；名冊 使成卷形；用渦卷飾裝飾 （似卷軸般）捲起（或展開）
scrutiny	詳細的檢查；仔細的觀察[U][C]；監視，監督[U][C]
sculptor	雕刻家[C]
seagull/gull	海鷗
seduce	誘惑；引誘；誘使墮落（或犯罪）[O]；誘姦
selective	有選擇性的；有選擇能力的
serene	安詳的；穩重的；晴朗的，無雲的；明亮的
sergeant	陸軍中士；海軍陸戰隊中士；【英】空軍中士
serial	連續的；一連串的；一系列的；分期刊載的；連載的 連載小說（或圖畫等）；連續影片；電視連續劇；（分期連載作品的）一個部分
sermon	布道，說教；（令人生厭的）冗長講話
serving	服務；侍候；（食物、飲料等）一份
setback	挫折；失敗；倒退；（疾病的）復發
shabby	破爛的；破舊的；邋遢的，骯髒的
sharpen	削尖，磨快；使敏銳；使敏捷 變尖；變鋒利；變得敏銳
shaver	理髮師；刮鬍鬚的用具
shortcoming	缺點，短處[P1]
shortsighted	近視的；目光短淺的，缺乏遠見的
shred	碎片，碎條；破布[P1][（+of）]；（通常用於否定句）最少量；些許；少量剩餘[S1][（+of）] 切成條狀；切絲；用碎紙機撕毀（文件）
shriek	尖叫；喊叫；發出尖聲；（尖叫似地）促人注意 尖聲發出[（+out）]；尖聲地表明 尖叫聲；尖聲[C]
shrub	矮樹；灌木[C]
shuffle	拖著腳走[Q]；跳曳步舞 拖著（腳）走；跳（曳步舞） 曳行，曳步[S]；曳步舞[S]
shutter	關閉者；關閉物；百葉窗；活動遮板[P] 為......裝百葉窗（或快門等）；關上......的百葉窗（或快門等）[H]
simplicity	簡單，簡易；簡明[U]；簡明易懂的事物[P]
simplify	簡化，精簡；使單純；使平易
simultaneous	同時發生的，同時存在的；同步的，一齊的[Z][（+with）]
skeptical	懷疑論的，不可知論的；懷疑宗教教條的
skim	撇去......表面的浮物；撇去，去除[（+off/away）] 飛快地掠過（或滑過）[（+over）]；瀏覽，略讀[（+through/over）] 撇；撇去的東西[U]；表面層[S][（+of）]
slang	俚語；行話；（盜賊等的）黑話，切口 【主英】用粗話罵；【英】【俚】欺騙，詐取 用粗話罵[（+at）]
slash	（用刀，劍等）砍；砍擊；砍傷，割傷；揮（劍，鞭等）；鞭打 猛砍，亂砍；揮擊[（+at）]；（雨）猛烈衝打[Q] 猛砍，亂砍；揮擊；砍傷，砍痕
slaughter	（食用牲口的）屠宰；（以人為對象的）（大）屠殺 宰殺，屠宰；殺戮，屠殺
slay	【書】殺死，殺害；【美】【俚】（過去式和過去分詞常作slayed）使大為高興，使禁不住大笑 殺死；致死
sloppy	稀薄的；【口】懶散的
slum	貧民窟；陋巷[the P]；【口】髒亂的地方 （為獵奇或救濟等）去貧民窟
slump	（突然或沉重地）倒下，陷落[Q][（+down）]；（物價等）下跌；（經濟等）衰落；（健康等）下降 使倒下；使降低；使衰落 暴跌；下降；不景氣；消沉，萎靡；衰退
sly	狡猾的，狡詐的；詭祕的，悄悄的
smuggle	走私，非法私運；偷運；偷帶 走私
sneaker(s)	【美】運動鞋
sneaky	鬼鬼祟祟的；暗中的
sneeze	噴嚏（聲）[C] 打噴嚏
snore	打鼾 打著鼾度過（時間）[（+away）] 打鼾；鼾聲[C]
sociable	好交際的；善交際的；社交性的，交際的 【美】社交聚會，聯誼會[C]
socialism	社會主義[U]
socialist	社會主義者；（大寫）社會黨黨員，社會黨人 社會主義（者）的；（大寫）社會黨人的
socialize	使適於社會生活；使符合群體生活之需要 參與社交；交際
sociology	社會學；【生】群體生態學
solemn	嚴肅的；莊重的；莊嚴的；隆重的；鄭重的
solidarity	團結；團結一致
solitary	單獨的，獨自的[Z][B]；單個的，唯一的[Z][B] 獨居者；隱士[C]；單獨監禁[U]
solitude	孤獨；寂寞；隱居[U]；冷僻（處）；荒涼（之地）[C][U]
soothe	安慰，撫慰；使平靜；哄；緩和；減輕 起撫慰（或鎮定）作用
sorrowful	悲傷的，傷心的；令人傷心的
sovereign	君主，元首；最高統治者；主權國家 最高統治者的；擁有最高統治權的；具有獨立主權的
spacecraft/spaceship	太空船
span	礅距；跨度；一段時間 （橋、拱等）橫跨，跨越；在......架橋；在......上建拱門
sparrow	麻雀[C]
spectacle	公開展示，場面；景象；奇觀，壯觀
spiral	螺旋（形）；螺線；蜷線；螺旋形的東西 螺旋（形）的；螺線的；蜷線的；盤旋的 盤旋；成螺旋形；螺旋形上升（或下降）；不斷加劇地增加（或減少） 使成螺旋形；使作螺旋形上升（或下降）
splendor	光輝；光彩[U]；壯麗；壯觀；輝煌[U][C]
spokesperson/spokesman/spokeswoman	發言人
spontaneous	自發的；非出於強制的；（動作等）無意識的，不由自主的
sportsman/sportswoman	喜好運動的人；喜好打獵等戶外運動的人；運動員，運動家；具有運動家品格的人
sportsmanship	運動員精神，運動道德；光明正大；運動技術；對運動的愛好
spotlight	（舞臺等的）聚光燈；聚光燈照明圈[C]；公眾注意的中心[the S] 聚光照明；使公眾注意；使突出醒目
spur	馬刺，靴刺；刺激，激勵；鼓舞[（+to）] 用靴刺踢[（+on）]；鞭策，鼓勵[（+on）] 策馬飛奔；急速前進；給予刺激
stabilize	使穩定，使穩固；平抑......的價格 穩定；安定
stagger	搖搖晃晃，蹣跚而行；猶豫，動搖；畏縮 使搖晃，使蹣跚；使猶豫（或畏縮） 搖晃，蹣跚[C]；（家畜）暈倒症[P][J]
staple	主要產品[P1]；主要商品；日常必需品[P1] 主要的；大宗生產的；經常需要的；經常用的 （按纖維長短）把......分級；把......分類
starvation	飢餓；挨餓；餓死[U]
statesman	政治家[C]
stationary	不動的；不增減的；定居的；常備軍的 不動的人（物）；常備軍
stationery	文具；信紙[U]
stature	身高，身材；（物體的）高度
statute	法令，法規；成文法；章程，規則；條例
stepchild	妻與前夫所生的孩子；夫與前妻所生的孩子；不受重視的人（或東西）；受到冷落的人（或東西）
stepfather	繼父，後父[C]
stepmother	繼母，後母[C]
stimulation	刺激；興奮；激勵；鼓舞[U]
strait	海峽[P1][J]；困境，危難[P] 【古】狹窄的；緊的；困難的；苦惱的
strangle	扼死；勒死；絞死；扼住，悶住，使窒息 被扼死；被勒死；被絞死；窒息而死
stray	迷路，走失；走散[（+from）]；閒逛；流浪 迷路的，走失的；流浪的 迷路者；流浪者
stride	邁大步走；跨，越[（+over/across）] 大踏步走過；跨過，越過 （一）大步，闊步；步幅；步姿[C]；進展，進步[P1]
stroll	散步，溜達；緩步走；流浪，（為謀生）輾轉各地 在......散步 散步；閒逛[S]
stun	把......打昏，使昏迷；使大吃一驚；使目瞪口呆[H] 打昏；昏迷；驚倒，驚歎；令人震驚的事物；令人驚歎的事物
stutter	結結巴巴地說話 結結巴巴地說出 結巴，口吃
stylish	時髦的，流行的；漂亮的
subjective	主觀的，主觀上的；個人的
subordinate	下級的[（+to）]；次要的；隸屬的[（+to）] 部下，部屬；下級職員[C]
subscribe	認捐；捐助[（+to）]；（在文件等下面）簽（名），署（名）[（+to）][O9] 認捐；捐款[（+to）]；訂閱；訂購（書籍等）[（+to/for）]
subscription	捐款，認捐[U][（+to）]；同意，贊成[C]
subsidize	給......津貼，補助，資助；用錢買通，向......行賄
succession	連續，接續[U]；一連串，一系列[S][（+of）]
successive	連續的，相繼的；依次的；接替的，後繼的；繼承的
suffocate	使窒息；把......悶死；扼制，壓制；阻礙 窒息，呼吸困難；被悶死；受扼制；受阻礙
suitcase	小型旅行箱；手提箱[C]
summon	召喚；傳喚；請求；要求[?]；召集
superficial	表面的；外表的[Z]；面的；面積的，平方的[Z]
superintendent	監督人，監管者；（機關，企業等的）主管，負責人
superiority	優越，優勢；上等；優等；上級[U][S1][（+to/over/in）]
superstitious	迷信的；因迷信而形成的
supplement	增補，補充[（+to）]；（書籍的）補遺；附錄；（報刊等的）增刊，副刊[（+to）]
suppress	鎮壓，平定；壓制；查禁；廢止；封鎖
surge	大浪，波濤；（波濤的）洶湧；奔騰 （海浪）洶湧；奔騰[Q]；（人）蜂擁而至[Q]
surgical	外科的；外科醫生的；外科（手術）用的[B]
surname	姓；別名，外號，綽號 給......姓氏；以姓氏稱呼；給......起別名（或綽號）；以別名（或綽號）稱呼
surpass	勝過；優於；大於；多於[（+in）]；非......所能辦到（或理解）
suspense	掛慮；擔心；懸念；懸疑；懸而不決，未定
suspension	懸掛，懸吊；懸浮；懸置[U]；暫停；中止；停職；停學[U][（+of/from）]
swamp	沼澤；沼澤地[C][U]；困境[C] 使陷入沼澤；使濕透；使沉沒；淹沒 陷入沼澤（或水中）；下沉；被淹沒
swarm	（昆蟲等的）群；蜂群；（密集的）一大群，一大批 （蜜蜂）分群[（+off）]；成群地移動（或飛行） 擠滿
symbolize	象徵，標誌；用符號表示[（+by）] 採用象徵，使用符號
symmetry	對稱（性）[U]；勻稱；整齊；對稱美[U]
sympathize	同情；憐憫；吊慰；體諒，諒解
symphony	交響樂，交響曲；【美】交響樂團，交響樂隊
synonym	同義字；類義字；【生】（分類學中的）同物異名
synthetic	綜合（性）的；合成的，人造的 合成物；合成纖維[C]
syrup	糖漿；果汁；【醫】含藥糖漿；單糖漿
tan	鞣（皮），硝（皮）；使曬成棕褐色 曬成棕褐色 鞣料，鞣酸[U]；棕褐色；曬成的棕褐膚色[U][S] 鞣革的；棕褐色的
tedious	冗長乏味的；使人厭煩的
telecommunications	電信學；電信
teller	敘述者；講故事者；【美】（銀行）出納員
tempo	【音】速度，拍子；發展進行速度
tenant	房客；佃戶；承租人；住戶，居住者 租，租賃[H]；居住於[H]
tentative	試驗性的，嘗試的；暫時性的；躊躇的，猶豫的
terrace	大陽臺；（庭院中的）露臺；平臺屋頂；（球場等周圍的）露天階梯看臺[P1] 使成梯形地；使有露臺（或平臺屋頂等）
textile	紡織品；紡織原料[C] 紡織的
thereafter	【書】之後，以後
thermometer	溫度計，寒暑表[C]
tilt	使傾斜；使翹起；使偏斜 傾斜；翹起；偏向 傾斜；傾側[C][U]；傾向，偏向[C][U]
tiptoe	腳趾尖；腳尖[C] 踮起腳走；躡手躡腳地走 踮著腳
tiresome	使人疲勞的；令人厭倦的；討厭的，煩人的
token	標記，標誌；象徵；紀念品 作為標記（或標誌）的；象徵性的；意思意思的；充場面的；裝點門面的；僅一點點的 表示；象徵
tornado	龍捲風；旋風；颶風；（非洲西部的）大雷颮
torrent	（水、熔岩等的）奔流；洪流；（雨的）傾注[P1]
trademark	商標；（人或物的）標記，特徵 用商標標明；給......的商標註冊；登記......作為商標
transcript	抄本，謄本；副本；（錄音的）文字記錄
transmit	傳送，傳達；傳（光、熱、聲等）；傳動 播送信號；發報
transplant	移植；移種[（+from/to）]；使移居[（+to）] 移居[（+to）]；耐移植
treasury	金庫；庫房；國庫[C]；寶庫，寶藏，珍藏室[C]
trek	艱苦跋涉；緩慢地行進；移居；離開 （牛）拉（車）；搬運 集體移居；（長途而辛苦的）旅行
trifle	小事，瑣事[C]；瑣碎的東西；小玩意兒，小裝飾品[C] 開玩笑；戲弄；小看，輕視 浪費；虛度[（+away）]
trillion	【英】百萬兆，一百萬的三次冪；【美】萬億，兆，一千的四次冪 【英】百萬兆的，一百萬的三次冪的；【美】萬億的，兆的，一千的四次冪的
tropic	回歸線[C]；熱帶[the P] 熱帶的；熱帶地方的
trout	鱒魚，鮭鱒魚[C]
trustee	（財產、業務等的）受託管理人；（學校、社團等的）理事會理事，董事 移交（財產或管理權）給受託人；【律】扣壓（債戶財產）以償欠款
tuck	把......塞進，把......藏入[O]；把......的邊塞到下面（或裡面） 縫褶襉；摺疊；收攏 （衣服等的）褶襉；打褶[C]；船尾突出部[C]
turmoil	騷動；混亂[U][C]
twilight	微明；薄暮；微光[U]；黃昏；黎明[U] 曙暮光的；微明的；昏暗的；衰落時期的；暮年的，晚期的
twinkle	（星等）閃爍；閃耀；（經光照耀而）閃閃發光 使閃爍；使閃耀；閃閃發出 閃爍，閃耀[the S]；（眼睛的）閃亮[S1]
unanimous	全體一致的；一致同意的；無異議的
unconditional	無條件的；絕對的
underestimate	低估；對......估計不足
underneath	在......下面，在......底下；在......的形式下；在......的喬裝下 在下面，在底下 下面的，底層的 下面，底部[the S]
underpass	【美】地下通道，下穿交叉道
underway	在進行中的
unification	統一；一致；聯合
unify	使成一體，統一，聯合；使相同；使一致 成一體，統一；成一致
unveil	除去......的面紗（或覆蓋物）；揭開......的幕；使公諸於眾；揭露 除去面紗（或覆蓋物）；揭幕；揭露出來
upright	挺直的，筆直的；豎的，直立的，垂直的 挺直地；垂直地；豎著 垂直；豎立[U]；直立的東西；柱[C] 使豎立
uprising	起義；暴動[C]；上升；起立；起床[U]
upward	向上的；升高的[B] 向上；在上面；以上；超過
upward/upwards	向上；在上面；以上；超過
urgency	緊急；迫切；催促；堅持
usher	（劇場等的）引座員，接待員；（法庭的）庭吏；（大學等的）門房，傳達員 引，領；招待；陪同[O][（+in/out）]；迎接[（+in）] 當引座員
utensil	器皿，用具[C]
utter	發出（聲音等）；說，講；表達；使流通；使用（尤指偽幣） 完全的，徹底的，十足的；無條件的，絕對的
vaccine	牛痘的；疫苗的 牛痘苗；疫苗
vanilla	【植】香子蘭；香草[C]；香子蘭浸液；香草精[U] 香草的；香草味的；平凡的；普通的；乏味的
vanity	自負；虛榮（心）[U]；虛幻；無意義，無益[U]
vapor	水汽，汽，蒸汽；煙霧[U][C]；無實質之物；幻想[C] 使汽化；蒸發；使憂鬱 汽化；蒸發；吹牛
veil	面紗，面罩[C]；帷幕；遮蔽物[S][（+of）] 以面紗遮掩；用帷幕分隔 戴面紗；【攝】出現輕度灰霧
velvet	天鵝絨，絲絨；天鵝絨裙衫 天鵝絨製的；用天鵝絨覆蓋的；天鵝絨似的，柔軟光滑的
versatile	多才多藝的；多功能的；多方面適用的
veterinarian/vet	【美】獸醫
veto	否決；否決權；否決權的行使[C][U]；禁止；反對[C][（+on）] 否決；禁止；反對
vibrate	顫動；振動；震動；（情感上）被撼動；感應，共鳴[（+to）] 使顫動；使振動；使震動；使擺動；用擺動指示
vibration	顫動；振動；震動[C][U]；擺動；搖擺[C][U]
vice	惡，邪惡[U]
victor	勝利者，戰勝者；得勝者[C]
vigor	體力；精力；活力；（動，植物的）強健，茁壯
vigorous	精力充沛的；壯健的；強有力的
villa	別墅；【英】（城郊）住宅
villain	壞人，惡棍；（戲劇、小說中的）反派角色，反面人物
vine	藤，藤蔓（植物）；葡萄樹 爬藤；形成藤蔓
vineyard	葡萄園[C]
violinist	小提琴手[C]
virgin	處女，未婚女子；（大寫）聖母瑪利亞[the S] 處女的，貞潔的[B]；純潔的，未玷汙的
vitality	活力，生氣；生命力
vocation	行業，職業[C]；（對特定職業的）稟性，傾向，才能[S][（+for）]
vocational	職業的[Z]
vowel	【文】母音；母音字母
wag	愛說笑打趣的人，能言善辯的人[C]；【英】【俚】逃學[the S] 【英】【俚】逃學[（+from）]
walnut	胡桃；胡桃樹[C]；胡桃木[U]
ward	病房，病室[C]；【主英】牢房[C] 【古】保護，守衛；避開；擋開；避免[（+off）]
wardrobe	衣櫥，衣櫃，藏衣室；（個人的）全部服裝；（劇團的）全部戲裝
warrant	授權；批准[U]；【律】授權令；逮捕狀；搜查令[C] 授權給；批准；使有（正當）理由，成為......的根據[+v-ing]
warranty	保證書；保單；擔保
waterproof	不透水的，防水的 防水材料；防水布[U]；【主英】雨衣[C] 使不透水，使防水；把......上膠
weary	疲倦的，疲勞的[（+with）]；厭倦的，厭煩的[F][（+of/with）] 使疲倦；使厭煩 疲倦；厭煩
wharf	碼頭；停泊處[C] 使（船）靠碼頭；把（貨物）卸在碼頭上 靠碼頭
whiskey/whisky	威士忌酒[U]；一杯威士忌酒[C]
wholesale	批發，躉售[U] 批發的；成批售出的；大批的；大規模的；不加區別的；全部的 以批發方式；大批地；大規模地；不加區別地；全部地 批發（貨物） 成批售出；經營批發業
wholesome	合乎衛生的；有益健康的；有益於身心健康的；有益的
widow/widower	寡婦[C]
withhold	抑制；阻擋；不給；保留[（+from）] 克制，自制[（+from）]
woe	悲哀；悲痛[U]；困難；災難；不幸[C][P1] （表示痛苦，悲傷或悔恨）哎喲，唉
woodpecker	啄木鳥[C]
workforce	"the people engaged in or available for work, either in a country or area or in a particular firm or industry"
wrestle	與......摔角，摔（角）；與......搏鬥 摔角，角力[（+with/against）]；鬥爭，搏鬥[（+with）] 摔角，角力；鬥爭，搏鬥
wrinkle	皺；皺紋；困難；難題 使起皺紋[（+up）] 起皺紋，皺起來
yearn	思念；渴望；嚮往[（+for/after/towards）][+to-v]；同情，憐憫[（+for/after）]
yoga	（亦作Y-）（印度的）瑜珈；瑜珈功
yogurt	酸奶；優格；= yoghurt
zoom	發出嗡嗡聲；（飛機）陡直上升；（物價）直線上升 使發嗡嗡聲；使急遽上升 嗡嗡聲；急遽上升
